match,insertion,deletion,soft_clipping,NM,lengths,INS_readLength,DEL_readLength,NM_INS_DEL
124417,79,44,0.0,270,124496,0.0006345585400334147,0.0003534250096388639,147
115813,241,125,10381.0,559,116054,0.0020766195047133233,0.001077084805349234,193
13203,57,13,14741.0,98,13260,0.004298642533936652,0.000980392156862745,28
9982,16,45,0.0,90,9998,0.0016003200640128026,0.004500900180036007,29
191446,1121,502,754694.0,2023,192567,0.005821350490997939,0.002606884876432618,400
1557518,23651,23202,17619434.0,57405,1581169,0.014957920374102958,0.014673953258633328,10552
20005,33,25,0.0,72,20038,0.0016468709452041122,0.0012476295039425091,14
972054,852,550,5298842.0,2608,972906,0.0008757269458714408,0.0005653166904099676,1206
51889,38,73,1726.0,157,51927,0.0007317965605561653,0.0014058197084368441,46
14635,29,20,0.0,66,14664,0.001977632296781233,0.001363884342607747,17
17515,62,57,0.0,137,17577,0.003527336860670194,0.0032428742106161462,18
20341,40,30,0.0,90,20381,0.001962612236887297,0.0014719591776654727,20
12562,38,80,0.0,190,12600,0.003015873015873016,0.006349206349206349,72
31177,91,59,0.0,218,31268,0.0029103236535755403,0.0018869131380324932,68
17475,49,178,0.0,400,17524,0.002796165259073271,0.010157498288062086,173
17914,76,194,0.0,419,17990,0.004224569205113952,0.010783768760422457,149
1003854,951,999,2117459.0,3486,1004805,0.0009464522967142879,0.00099422275963993,1536
133706,62,106,0.0,324,133768,0.0004634890257759703,0.0007924167214879492,156
32734,75,44,0.0,134,32809,0.0022859581212472187,0.0013410954311317016,15
586463,368,215,1221355.0,912,586831,0.0006270970688324237,0.0003663746461928562,329
12845,11,24,0.0,49,12856,0.0008556316116988177,0.001866832607342875,14
32809,18,31,0.0,87,32827,0.0005483291193225089,0.0009443445943887654,38
2408209,9090,8312,17526118.0,22706,2417299,0.003760395383442429,0.003438548561845266,5304
836442,375,315,815215.0,1457,836817,0.0004481266513467102,0.0003764263871312366,767
1083124,700,525,2679966.0,2330,1083824,0.0006458613206572285,0.00048439599049292134,1105
7425,11,18,5439.0,47,7436,0.0014792899408284023,0.002420656266810113,18
18514,20,138,3898.0,168,18534,0.0010790978741771879,0.007445775331822596,10
67252,45,38,0.0,166,67297,0.0006686776527928437,0.000564661129025068,83
64321,153,51,0.0,270,64474,0.0023730496013897075,0.0007910165337965692,66
16105,67,58,0.0,151,16172,0.00414296314617858,0.003586445708632204,26
29737,64,184,2.0,289,29801,0.0021475789403040168,0.006174289453374048,41
27834,133,133,0.0,532,27967,0.004755604819966389,0.004755604819966389,266
62793,456,826,15543.0,2995,63249,0.007209600151781056,0.013059495011778843,1713
52469,37,55,0.0,151,52506,0.0007046813697482192,0.0010474993334095152,59
11743,25,81,0.0,191,11768,0.002124405166553365,0.006883072739632903,85
22031,29,141,0.0,234,22060,0.001314596554850408,0.006391659111514052,64
37830,18,81,7530.0,170,37848,0.0004755865567533291,0.002140139505389981,71
49334,75,50,0.0,171,49409,0.0015179420753304053,0.0010119613835536036,46
51299,36,185,0.0,295,51335,0.0007012759325995909,0.003603779098081231,74
53071,23,123,0.0,195,53094,0.00043319395788601347,0.0023166459486947677,49
27278,63,70,0.0,164,27341,0.002304231739877839,0.0025602574887531545,31
36008,36,157,8.0,285,36044,0.0009987792697813782,0.004355787370991011,92
13817,18,22,0.0,68,13835,0.0013010480664980124,0.0015901698590531262,28
37589,86,321,2.0,526,37675,0.002282680822826808,0.008520238885202388,119
21398,49,47,0.0,158,21447,0.002284701823098802,0.002191448687462116,62
22967,101,138,0.0,580,23068,0.004378359632391192,0.005982313161088954,341
30871,180,54,3613.0,312,31051,0.005796914753148047,0.001739074425944414,78
45603,78,42,0.0,182,45681,0.001707493268536153,0.0009194194522886977,62
23908,48,86,0.0,248,23956,0.0020036734012355987,0.0035899148438804473,114
64270,51,44,0.0,221,64321,0.0007928981203650441,0.0006840689665894498,126
22128,38,90,0.0,195,22166,0.0017143372733014527,0.0040602724893981776,67
87233,58,100,0.0,341,87291,0.0006644442153257495,0.0011455934746995682,183
15032,11,66,0.0,130,15043,0.0007312371202552682,0.004387422721531609,53
58109,62,283,0.0,442,58171,0.0010658231764968799,0.004864967079816403,97
21233,67,102,0.0,195,21300,0.0031455399061032863,0.004788732394366197,26
30489,13,42,0.0,85,30502,0.00042620156055340634,0.0013769588879417743,30
121704,93,199,0.0,547,121797,0.0007635656050641641,0.0016338661871803082,255
20327,25,89,0.0,254,20352,0.001228380503144654,0.0043730345911949684,140
110731,16,32,0.0,114,110747,0.00014447343946111406,0.0002889468789222281,66
22711,34,24,0.0,121,22745,0.0014948340294570234,0.0010551769619696638,63
23293,66,64,0.0,203,23359,0.002825463418810737,0.002739843315210411,73
24458,43,97,0.0,210,24501,0.0017550304069221664,0.0039590220807313985,70
13512,62,137,0.0,317,13574,0.004567555621040224,0.01009282451745985,118
15950,4,6,0.0,75,15954,0.00025072082236429733,0.000376081233546446,65
35480,5,38,0.0,426,35485,0.0001409046075806679,0.001070875017613076,383
10527,8,55,0.0,169,10535,0.0007593735168485999,0.005220692928334125,106
18278,10,31,37.0,220,18288,0.0005468066491688539,0.001695100612423447,179
16170,57,193,2.0,424,16227,0.003512664078387872,0.011893757318050164,174
6918,13,164,7653.0,268,6931,0.0018756312220458808,0.02366180926273265,91
19605,30,53,8236.0,330,19635,0.0015278838808250573,0.0026992615227909343,247
16948,25,33,0.0,258,16973,0.0014729275908796323,0.0019442644199611147,200
18713,36,52,14408.0,328,18749,0.0019201024054616247,0.002773481252333458,240
20853,8,9,6601.0,303,20861,0.00038349072431810555,0.00043142706485786877,286
18469,67,422,1292.0,728,18536,0.0036145878290893396,0.022766508416055244,239
17688,19,426,2970.0,674,17707,0.0010730219687129384,0.024058282035353252,229
26710,8,39,2156.0,371,26718,0.0002994236095516131,0.0014596900965641142,324
17941,7,9,3448.0,224,17948,0.000390015600624025,0.0005014486293737464,208
19580,9,13,1822.0,277,19589,0.00045944152330389506,0.000663637755883404,255
15489,217,61,11342.0,576,15706,0.013816375907296575,0.003883866038456641,298
13982,17,270,41701.0,485,13999,0.0012143724551753696,0.019287091935138223,198
17788,28,15,2323.0,296,17816,0.001571621014818141,0.0008419398293668612,253
17794,8,9,10023.0,273,17802,0.00044938770924615214,0.0005055611729019212,256
18418,17,29,3601.0,289,18435,0.0009221589368049905,0.001573094656902631,243
17789,21,77,35.0,330,17810,0.0011791128579449748,0.004323413812464908,232
23446,19,26,2475.0,350,23465,0.0008097165991902834,0.00110803324099723,305
14713,8,33,1952.0,255,14721,0.0005434413423001155,0.0022416955369879764,214
14714,12,32,2502.0,256,14726,0.0008148852369957897,0.0021730272986554395,212
12240,14,52,140.0,210,12254,0.0011424840868287905,0.004243512322506937,144
19297,31,18,3.0,294,19328,0.0016038907284768211,0.0009312913907284768,245
14465,10,105,2061.0,307,14475,0.000690846286701209,0.007253886010362694,192
15930,20,29,0.0,246,15950,0.0012539184952978057,0.0018181818181818182,197
14301,9,34,256.0,231,14310,0.0006289308176100629,0.0023759608665269044,188
13425,9,24,0.0,200,13434,0.0006699419383653417,0.001786511835640911,167
13904,14,39,703.0,239,13918,0.0010058916510992959,0.0028021267423480383,186
18133,35,32,2.0,303,18168,0.0019264641127256716,0.0017613386173491853,236
13483,12,36,1244.0,224,13495,0.000889218228973694,0.002667654686921082,176
13409,15,27,2707.0,220,13424,0.0011174016686531585,0.0020113230035756855,178
34177,28,30,0.0,453,34205,0.0008185937728402281,0.00087706475661453,395
18571,22,34,14.0,300,18593,0.0011832410046791802,0.0018286451890496423,244
15251,49,76,157.0,336,15300,0.0032026143790849673,0.0049673202614379085,211
14834,27,19,3533.0,247,14861,0.0018168360137272054,0.0012785142318821076,201
17608,24,16,0.0,268,17632,0.0013611615245009074,0.0009074410163339383,228
14735,13,11,3400.0,241,14748,0.000881475454298888,0.0007458638459452129,217
13601,29,35,2258.0,255,13630,0.002127659574468085,0.0025678650036683784,191
12220,45,64,198.0,288,12265,0.0036689767631471666,0.005218100285364859,179
11682,9,7,8130.0,196,11691,0.0007698229407236335,0.0005987511761183816,180
11675,11,14,10793.0,202,11686,0.0009412972787951394,0.001198014718466541,177
11676,10,13,8811.0,204,11686,0.0008557247989046722,0.001112442238576074,181
11682,8,7,15662.0,196,11690,0.0006843455945252353,0.0005988023952095808,181
11670,7,19,11125.0,187,11677,0.0005994690417059176,0.0016271302560589191,161
11659,11,30,8386.0,212,11670,0.0009425878320479863,0.002570694087403599,171
23616,25,14,6557.0,342,23641,0.001057484877966245,0.0005921915316610973,303
13092,43,28,2528.0,232,13135,0.0032736962314427105,0.0021317091739626952,161
17528,9,25,0.0,250,17537,0.0005132006614586303,0.0014255573929406397,216
11481,37,82,4772.0,281,11518,0.0032123632575099845,0.007119291543670776,162
17411,25,17,3259.0,290,17436,0.0014338150952053223,0.0009749942647396192,248
11091,14,32,12399.0,194,11105,0.0012606933813597478,0.0028815848716794235,148
13988,71,69,3788.0,347,14059,0.00505014581406928,0.004907888185503947,207
13643,6,69,0.0,243,13649,0.0004395926441497546,0.0050553154077221775,168
19763,9,62,346.0,323,19772,0.0004551891563827635,0.0031357475217479265,252
27080,29,106,5953.0,477,27109,0.0010697554317754252,0.0039101405437308645,342
19747,19,17,10914.0,305,19766,0.0009612465850450268,0.0008600627339876556,269
10375,18,56,9999.0,216,10393,0.001731934956220533,0.005388242086019436,142
24131,28,14,0.0,346,24159,0.001158988368723871,0.0005794941843619355,304
10309,39,27,2753.0,215,10348,0.0037688442211055275,0.0026091998453807498,149
13165,22,10,1174.0,212,13187,0.0016683096989459315,0.0007583225904299689,180
10039,19,12,5796.0,189,10058,0.0018890435474249354,0.0011930801352157488,158
9896,64,20,5555.0,228,9960,0.00642570281124498,0.002008032128514056,144
25152,55,161,0.0,532,25207,0.0021819335898758284,0.006387114690363788,316
9076,14,158,12865.0,309,9090,0.0015401540154015402,0.01738173817381738,137
12141,23,35,1994.0,227,12164,0.0018908253863860573,0.0028773429792831305,169
12026,48,27,516.0,255,12074,0.003975484512174921,0.002236210038098393,180
12002,17,24,665.0,215,12019,0.0014144271570014145,0.0019968383392961146,174
11529,84,41,0.0,282,11613,0.007233273056057866,0.0035305261345044345,157
8667,12,60,1973.0,209,8679,0.00138264777048047,0.0069132388524023505,137
11905,10,9,10841.0,200,11915,0.000839278220730172,0.0007553503986571548,181
8572,23,60,4872.0,240,8595,0.0026759744037230947,0.006980802792321117,157
11665,16,24,3744.0,233,11681,0.0013697457409468368,0.002054618611420255,193
11673,27,16,4550.0,239,11700,0.002307692307692308,0.0013675213675213675,196
11611,33,78,4883.0,301,11644,0.0028340776365510132,0.006698728959120577,190
11623,41,66,5350.0,306,11664,0.0035150891632373116,0.00565843621399177,199
10426,15,98,8192.0,283,10441,0.001436643999616895,0.00938607413083038,170
11682,8,7,18470.0,209,11690,0.0006843455945252353,0.0005988023952095808,194
9873,17,12,8642.0,184,9890,0.0017189079878665318,0.0012133468149646107,155
14386,14,254,11185.0,484,14400,0.0009722222222222222,0.017638888888888888,216
17576,14,18,3264.0,284,17590,0.0007959067652075042,0.001023308698123934,252
17536,15,42,5108.0,299,17551,0.0008546521565722751,0.00239302603840237,242
11321,29,61,871.0,257,11350,0.002555066079295154,0.005374449339207049,167
11289,37,11,9775.0,222,11326,0.0032668197068691507,0.0009712166696097474,174
11080,12,48,6024.0,225,11092,0.0010818608005769925,0.00432744320230797,165
7983,48,27,5071.0,208,8031,0.005976839745984311,0.0033619723571161747,133
17001,8,15,0.0,248,17009,0.0004703392321712035,0.0008818860603210066,225
10867,11,14,641.0,189,10878,0.0010112152969295827,0.001287001287001287,164
7725,8,23,7024.0,151,7733,0.001034527350316824,0.002974266132160869,120
10661,14,29,17770.0,194,10675,0.0013114754098360656,0.0027166276346604215,151
8624,8,7,6841.0,168,8632,0.0009267840593141798,0.0008109360518999073,153
8610,9,21,4679.0,184,8619,0.0010442046641141664,0.0024364775495997215,154
5565,8,9,22287.0,132,5573,0.0014354925533823794,0.0016149291225551767,115
8020,6,9,19322.0,145,8026,0.00074757039621231,0.001121355594318465,130
15513,129,525,0.0,871,15642,0.008247027234369007,0.033563482930571535,217
15481,318,147,3.0,712,15799,0.020127856193429963,0.00930438635356668,247
13541,70,346,3371.0,571,13611,0.005142899125707149,0.025420615678495333,155
22421,3,39,26.0,261,22424,0.0001337852301105958,0.0017392079914377453,219
17932,7,82,0.0,285,17939,0.00039021127153130054,0.004571046323652377,196
12281,7,43,0.0,168,12288,0.0005696614583333334,0.0034993489583333335,118
11890,4,37,21.0,159,11894,0.00033630401883302503,0.0031108121742054818,118
11868,10,53,5.0,171,11878,0.0008418925745074928,0.0044620306448897125,108
11324,3,49,11.0,161,11327,0.0002648538889379359,0.004325946852652953,109
10904,16,52,0.0,176,10920,0.0014652014652014652,0.004761904761904762,108
27035,6,34,104.0,391,27041,0.00022188528530749603,0.0012573499500758108,351
24184,11,72,0.0,404,24195,0.00045463938830336847,0.0029758214507129574,321
25759,8,89,5328.0,432,25767,0.00031047463810299995,0.0034540303488958747,335
23490,38,48,700.0,411,23528,0.0016150969058143488,0.002040122407344441,325
23718,12,11,7541.0,347,23730,0.0005056890012642225,0.00046354825115887065,324
8624,9,2,11285.0,187,8633,0.0010425112938723504,0.00023166917641607784,176
13057,11,319,13566.0,557,13068,0.0008417508417508417,0.02441077441077441,227
13951,6,3,0.0,205,13957,0.00042989181056100884,0.00021494590528050442,196
19821,46,75,0.0,386,19867,0.002315397392661197,0.0037751044445562994,265
22568,118,95,0.0,498,22686,0.0052014458256193245,0.0041876046901172526,285
11084,147,104,10088.0,418,11231,0.013088772148517495,0.009260083696910337,167
21756,43,312,51.0,651,21799,0.0019725675489701364,0.014312583146015872,296
12454,13,76,9709.0,365,12467,0.0010427528675703858,0.006096093687334563,276
14592,10,43,3290.0,267,14602,0.0006848376934666484,0.002944802081906588,214
29913,51,1234,0.0,1601,29964,0.0017020424509411295,0.04118275263649713,316
17419,6,21,0.0,193,17425,0.0003443328550932568,0.0012051649928263989,166
17224,42,249,0.0,476,17266,0.0024325263523688172,0.014421406231900845,185
16828,29,57,18.0,255,16857,0.0017203535623183247,0.003381384588004983,169
16864,6,36,0.0,204,16870,0.00035566093657379963,0.0021339656194427977,162
25959,13,49,0.0,321,25972,0.0005005390420452795,0.0018866471584783613,259
19165,6,39,1965.0,221,19171,0.00031297271921130874,0.0020343226748735068,176
23689,12,58,2.0,300,23701,0.0005063077507278174,0.002447154128517784,230
14590,14,368,108.0,536,14604,0.000958641468090934,0.02519857573267598,154
17350,6,41,6.0,211,17356,0.00034570177460244297,0.00236229545978336,164
22963,31,131,0.0,375,22994,0.0013481777855092632,0.0056971383839262415,213
30849,5,16,0.0,326,30854,0.00016205354249043883,0.0005185713359694043,305
16489,17,45,258.0,230,16506,0.0010299285108445414,0.0027262813522355507,168
25523,7,107,0.0,364,25530,0.00027418723070896984,0.004191147669408539,250
21828,4,72,0.0,281,21832,0.00018321729571271528,0.003297911322828875,205
18062,358,519,2358.0,1184,18420,0.019435396308360477,0.028175895765472313,307
22581,355,533,15097.0,1265,22936,0.015477851412626439,0.023238576909661666,377
27104,359,848,8344.0,1600,27463,0.013072133415868624,0.03087790845865346,393
28962,355,540,2134.0,1614,29317,0.01210901524712624,0.018419347136473717,719
19213,353,538,1656.0,1198,19566,0.018041500562199733,0.027496677910661353,307
18413,490,816,0.0,1679,18903,0.025921811352695338,0.043167751150611014,373
19718,347,530,5277.0,1188,20065,0.01729379516571144,0.02641415399950162,311
16884,356,578,12524.0,1222,17240,0.020649651972157772,0.033526682134570766,288
17338,357,516,0.0,1138,17695,0.020175190731845153,0.02916077988132241,265
17352,369,530,0.0,1157,17721,0.020822752666328086,0.02990801873483438,258
21576,349,514,6146.0,1206,21925,0.015917901938426453,0.02344355758266819,343
15410,363,532,20759.0,1161,15773,0.023014011285107463,0.03372852342610791,266
23814,543,826,1828.0,1804,24357,0.0222933858849612,0.03391222235907542,435
27002,363,530,107.0,1269,27365,0.01326511967842134,0.0193678055910835,376
24311,361,534,763.0,1261,24672,0.014631971465629053,0.02164396887159533,366
15156,351,576,3889.0,1182,15507,0.022634939059779455,0.0371445153801509,255
19384,349,514,2088.0,1174,19733,0.01768610956266153,0.026047737292859675,311
16570,351,579,2262.0,1198,16921,0.020743454878553277,0.03421783582530583,268
16399,413,536,4543.0,1195,16812,0.02456578634308827,0.03188198905543659,246
16586,349,532,10411.0,1141,16935,0.02060820785355772,0.03141423088278713,260
17418,492,858,0.0,1589,17910,0.02747068676716918,0.047906197654941376,239
15103,361,555,3716.0,1170,15464,0.0233445421624418,0.03588980858768753,254
11693,358,528,13090.0,1198,12051,0.02970707825076757,0.04381379138660692,312
20062,351,515,5913.0,1181,20413,0.01719492480282173,0.025229020722088866,315
17604,350,521,4970.0,1157,17954,0.019494263116854184,0.02901860309680294,286
15533,399,531,1969.0,1190,15932,0.025043936731107205,0.033329148882751694,260
24351,351,520,2430.0,1224,24702,0.01420937575904785,0.02105092705044126,353
13430,356,698,5766.0,1296,13786,0.025823298998984476,0.05063107500362687,242
14965,23,256,0.0,512,14988,0.0015345609821190286,0.017080330931411796,233
12254,67,386,0.0,753,12321,0.005437870302735168,0.03132862592322052,300
25189,37,51,805.0,419,25226,0.0014667406643938793,0.002021723618488861,331
15167,19,7,5239.0,249,15186,0.0012511523771895168,0.000460950875806664,223
15412,8,5,6613.0,239,15420,0.0005188067444876783,0.00032425421530479895,226
13798,20,23,400.0,245,13818,0.0014473874656245477,0.0016644955854682299,202
13582,50,35,4025.0,286,13632,0.0036678403755868545,0.0025674882629107983,201
17793,20,6,6738.0,299,17813,0.0011227755010385673,0.0003368326503115702,273
14306,34,24,124.0,268,14340,0.002370990237099024,0.0016736401673640166,210
18452,51,13,2068.0,322,18503,0.0027563097876020103,0.0007025887693887478,258
14009,12,13,8843.0,234,14021,0.0008558590685400471,0.000927180657585051,209
13564,46,24,3081.0,271,13610,0.0033798677443056574,0.001763409257898604,201
14539,32,138,20696.0,378,14571,0.002196143023814426,0.009470866790199713,208
14425,11,13,11769.0,245,14436,0.0007619839290662233,0.0009005264616237184,221
17766,42,21,3520.0,327,17808,0.0023584905660377358,0.0011792452830188679,264
13987,35,61,126.0,303,14022,0.002496077592354871,0.004350306660961346,207
13623,55,68,4089.0,326,13678,0.004021055709899108,0.004971487059511625,203
15890,14,39,21533.0,276,15904,0.0008802816901408451,0.0024522132796780684,223
9743,24,55,1150.0,234,9767,0.002457254018634176,0.005631207126036654,155
18612,162,164,1777.0,656,18774,0.00862895493767977,0.008735485245552359,330
9395,12,39,13677.0,201,9407,0.001275645795684065,0.004145848835973211,150
17916,31,22,0.0,288,17947,0.0017273081852120131,0.0012258316153117513,235
8342,44,90,3816.0,293,8386,0.005246839971380873,0.010732172668733603,159
8836,10,37,13650.0,188,8846,0.0011304544426859599,0.004182681437938051,141
11875,16,12,2348.0,206,11891,0.0013455554621142041,0.001009166596585653,178
14940,11,60,0.0,264,14951,0.0007357367400173901,0.004013109491003947,193
13605,9,6,2096.0,207,13614,0.0006610841780520053,0.00044072278536800354,192
11323,41,145,2426.0,355,11364,0.003607884547694474,0.012759591693065822,169
8602,35,24,6175.0,218,8637,0.004052332985990506,0.0027787426189649182,159
8617,15,9,7258.0,179,8632,0.001737720111214087,0.0010426320667284523,155
14602,18,139,15767.0,378,14620,0.0012311901504787962,0.009507523939808481,221
14096,12,55,7320.0,259,14108,0.0008505812305075135,0.00389849730649277,192
11652,13,32,9062.0,228,11665,0.0011144449207029575,0.002743249035576511,183
7197,9,24,5219.0,152,7206,0.0012489592006661116,0.0033305578684429643,119
11564,15,12,1897.0,202,11579,0.0012954486570515588,0.001036358925641247,175
8490,12,28,14918.0,176,8502,0.0014114326040931546,0.003293342742884027,136
11507,13,69,16632.0,250,11520,0.0011284722222222221,0.005989583333333334,168
11075,15,38,4460.0,196,11090,0.001352569882777277,0.0034265103697024347,143
14357,39,50,0.0,263,14396,0.0027090858571825506,0.0034731869963878855,174
17072,25,23,1511.0,266,17097,0.0014622448382757209,0.0013452652512136632,218
16930,48,20,0.0,272,16978,0.0028271881258098716,0.0011779950524207798,204
17462,32,37,37.0,291,17494,0.0018291985823710986,0.002115010860866583,222
15208,39,80,486.0,310,15247,0.002557880238735489,0.005246933823047157,191
16286,436,353,5992.0,1106,16722,0.02607343619184308,0.021109915081928,317
13864,508,786,0.0,1491,14372,0.035346507097133315,0.054689674366824384,197
22750,386,573,0.0,1242,23136,0.016683955739972337,0.024766597510373443,283
25712,389,587,3421.0,1789,26101,0.014903643538561741,0.02248955978698134,813
21467,369,615,1364.0,1275,21836,0.01689869939549368,0.028164498992489465,291
19451,374,572,5202.0,1211,19825,0.018865069356872637,0.028852459016393443,265
15444,357,617,2256.0,1183,15801,0.022593506740079743,0.03904816150876527,209
21576,390,617,0.0,1296,21966,0.01775471182736957,0.02808886460894109,289
13876,365,515,14331.0,1087,14241,0.02563022259672776,0.036163190787163825,207
14631,399,590,1252.0,1213,15030,0.02654690618762475,0.039254823685961414,224
14214,386,541,1009.0,1141,14600,0.026438356164383562,0.03705479452054795,214
13855,348,553,1551.0,1119,14203,0.024501865802999366,0.03893543617545589,218
13602,363,632,7827.0,1208,13965,0.02599355531686359,0.045255997135696384,213
10805,352,557,11078.0,1072,11157,0.031549699740073496,0.04992381464551403,163
10809,345,541,5747.0,1061,11154,0.030930607853684778,0.04850277927201004,175
13327,342,533,8765.0,1071,13669,0.025020118516350866,0.0389933426000439,196
13888,341,520,17535.0,1079,14229,0.023965141612200435,0.036545083983414155,218
30709,12,29,54070.0,55,30721,0.0003906122847563556,0.0009439796881611927,14
130117,220,428,121.0,1117,130337,0.0016879320530624458,0.0032837950850487583,469
26521,28,95,0.0,151,26549,0.0010546536592715356,0.003578289201099853,28
38671,11,49,0.0,105,38682,0.0002843699912103821,0.0012667390517553383,45
32113,32,201,24912.0,295,32145,0.0009954891896095815,0.006252916472235184,62
57707,240,277,0.0,1444,57947,0.004141715705731099,0.004780230210364643,927
14642,11,12,13667.0,44,14653,0.0007506995154575854,0.0008189449259537297,21
27079,72,64,0.0,257,27151,0.002651836028138927,0.002357187580567935,121
35178,10,17,0.0,39,35188,0.00028418779129248605,0.00048311924519722635,12
24148,16,23,0.0,47,24164,0.0006621420294653203,0.0009518291673563979,8
32019,59,141,0.0,261,32078,0.001839266787206185,0.004395535881289357,61
21749,25,18,15075.0,58,21774,0.0011481583540001838,0.0008266740148801323,15
19452,30,146,15713.0,290,19482,0.001539882968894364,0.007494097115285905,114
18809,53,121,2474.0,222,18862,0.0028098823030431558,0.0064150143144947516,48
24935,111,142,0.0,349,25046,0.0044318454044558015,0.005669567994889404,96
26143,84,31,0.0,145,26227,0.0032028062683494107,0.0011819880276051397,30
29313,108,115,0.0,357,29421,0.0036708473539308656,0.0039087726453893475,134
156833,358,214,0.0,917,157191,0.0022774840798773467,0.0013614010980272408,345
28607,37,138,0.0,210,28644,0.0012917190336545175,0.004817762882279012,35
21234,21,69,0.0,150,21255,0.0009880028228652082,0.0032462949894142556,60
50359,144,193,0.0,792,50503,0.002851315763419995,0.0038215551551392985,455
39432,13,22,0.0,64,39445,0.00032957282291798704,0.0005577386233996704,29
42033,78,444,0.0,639,42111,0.0018522476312602407,0.01054356343948137,117
22231,33,64,0.0,186,22264,0.0014822134387351778,0.002874595759971254,89
84981,66,63,0.0,178,85047,0.0007760414829447247,0.0007407668700836009,49
86304,125,113,0.0,671,86429,0.0014462738201298174,0.001307431533397355,433
206791,80,148,0.0,561,206871,0.0003867144258982651,0.0007154216879117904,333
165206,78,41,87200.0,376,165284,0.00047191500689721934,0.00024805788824084604,257
1380253,1256,976,2518406.0,3907,1381509,0.0009091507909105189,0.0007064738630005306,1675
1622723,999,1009,12333834.0,3432,1623722,0.0006152531036716876,0.0006214117933981309,1424
15705,10,14,7448.0,30,15715,0.0006363347120585428,0.0008908685968819599,6
17762,53,28,0.0,97,17815,0.0029750210496772385,0.0015717092337917485,16
15127,5,12,4786.0,33,15132,0.00033042558815754694,0.0007930214115781126,16
9390,33,62,8375.0,187,9423,0.0035020694046482012,0.0065796455481269235,92
2429812,1806,1658,48626422.0,5145,2431618,0.0007427153442687133,0.000681850520928863,1681
12015,31,38,11880.0,114,12046,0.0025734683712435665,0.0031545741324921135,45
37080,42,60,0.0,146,37122,0.0011314045579440763,0.0016162922256343947,44
1378925,379,516,1077344.0,1587,1379304,0.00027477626397081424,0.000374101720867916,692
17957,32,53,8308.0,137,17989,0.0017788648618600256,0.002946244927455667,52
2621449,2252,1707,25577753.0,6130,2623701,0.0008583295123948956,0.0006506076721394702,2171
347358,631,407,452731.0,1623,347989,0.0018132757069907381,0.0011695771992792875,585
52966,298,110,0.0,530,53264,0.005594773205166717,0.002065184740162211,122
7426,6,20,6673.0,38,7432,0.0008073196986006459,0.002691065662002153,12
820817,760,664,1225610.0,2327,821577,0.0009250502387481636,0.0008082017875378693,903
37932,73,41,2379.0,634,38005,0.0019207998947506908,0.001078805420339429,520
30278,80,163,12.0,585,30358,0.0026352197114434418,0.005369260162066012,342
28926,46,205,529.0,404,28972,0.001587739886787243,0.007075797321551843,153
1033560,414,498,4649194.0,1886,1033974,0.0004003969152028968,0.0004816368690121802,974
166332,185,76,290471.0,428,166517,0.0011109976759129698,0.00045640985605073357,167
248085,264,381,192730.0,1102,248349,0.001063020185303746,0.0015341314037906333,457
224594,1361,2216,0.0,4684,225955,0.0060233232280763865,0.00980726250802151,1107
289105,793,195,529629.0,1420,289898,0.0027354448806131814,0.0006726503804786511,432
198244,174,235,155335.0,627,198418,0.0008769365682548962,0.0011843683536775897,218
59051,460,221,5.0,878,59511,0.007729663423568752,0.0037135991665406395,197
309690,3348,2363,1188973.0,6970,313038,0.0106951871657754,0.007548604322797871,1259
11416,225,174,14406.0,513,11641,0.01932823640580706,0.01494716948715746,114
127083,14,17,113289.0,110,127097,0.0001101520885622792,0.00013375610753991047,79
44649,546,335,51115.0,922,45195,0.01208098240955858,0.007412324372165062,41
137656,71,304,0.0,552,137727,0.0005155125719720897,0.0022072650968945813,177
69529,1023,1128,13200.0,2705,70552,0.014499943304229504,0.015988207279736932,554
