match,insertion,deletion,soft_clipping,NM,lengths,INS_readLength,DEL_readLength,NM_INS_DEL
48218,40,39,16594.0,228,48258,0.0008288781134734137,0.0008081561606365783,149
422361,194,60,86276.0,365,422555,0.00045911183159588694,0.00014199334997810935,111
7611,85,133,2781.0,231,7696,0.011044698544698545,0.017281704781704783,13
298183,806,778,178966.0,1974,298989,0.0026957513487118256,0.002602102418483623,390
139442,319,436,238778.0,1120,139761,0.0022824679273903306,0.003119611336495875,365
944207,1311,908,1166721.0,2899,945518,0.0013865415571147244,0.0009603201631275132,680
16702,73,128,0.0,251,16775,0.004351713859910581,0.007630402384500745,50
14889,111,100,0.0,279,15000,0.0074,0.006666666666666667,68
204626,347,470,130729.0,1148,204973,0.001692905894922746,0.0022929849297224515,331
52970,69,119,0.0,320,53039,0.0013009295047040857,0.0022436320443447273,132
24204,68,75,0.0,188,24272,0.0028015820698747526,0.0030899802241265654,45
12179,30,394,0.0,488,12209,0.0024572037021869113,0.03227127528872144,64
35325,89,106,0.0,271,35414,0.002513130400406619,0.0029931665443045123,76
43941,90,209,0.0,484,44031,0.0020440144443687404,0.0047466557652562965,185
22544,10,68,0.0,136,22554,0.0004433803316484881,0.0030149862552097187,58
29891,26,193,0.0,563,29917,0.0008690710967008724,0.0064511816024333994,344
36106,41,158,0.0,443,36147,0.0011342573380916812,0.004371040473621601,244
27626,38,170,0.0,474,27664,0.0013736263736263737,0.0061451706188548295,266
43338,154,213,1936.0,829,43492,0.0035408810815782212,0.004897452405040008,462
16688,40,83,0.0,146,16728,0.0023912003825920613,0.004961740793878527,23
26480,274,216,128.0,1266,26754,0.010241459221051057,0.008073559093967257,776
23590,68,98,0.0,287,23658,0.002874291994251416,0.004142361991715276,121
21266,58,489,7.0,933,21324,0.0027199399737385106,0.02293190770962296,386
25685,25,48,0.0,170,25710,0.0009723842862699338,0.0018669778296382731,97
32042,249,346,18464.0,1099,32291,0.007711126939394877,0.010715059923817782,504
19344,102,140,0.0,455,19446,0.005245294662141314,0.007199424046076314,213
16052,59,109,1189.0,250,16111,0.0036620942213394575,0.006765563900440693,82
1519964,948,976,2159734.0,3456,1520912,0.0006233102243916808,0.0006417202310192832,1532
24798,43,68,0.0,188,24841,0.00173100921863049,0.0027374099271365885,77
464060,625,462,617264.0,1904,464685,0.001344997148606045,0.0009942218922495884,817
14767,18,144,0.0,172,14785,0.0012174501183632059,0.009739600946905647,10
28868,127,223,0.0,587,28995,0.004380065528539403,0.007690981203655803,237
79350,75,223,0.0,379,79425,0.0009442870632672333,0.002807680201447907,81
30131,242,402,0.0,1723,30373,0.00796760280512297,0.01323543937049353,1079
25639,29,154,0.0,282,25668,0.0011298114383668382,0.0059996883278790715,99
17707,25,33,2004.0,102,17732,0.0014098804421385067,0.0018610421836228288,44
16507,47,61,4107.0,185,16554,0.0028391929443034917,0.0036849099915428297,77
21334,33,47,0.0,119,21367,0.0015444376842794964,0.0021996536715495857,39
21125,67,230,2.0,689,21192,0.0031615704039260097,0.010853152132880333,392
16422,32,145,0.0,189,16454,0.0019448158502491796,0.008812446821441595,12
17141,119,292,0.0,521,17260,0.006894553881807648,0.016917728852838935,110
59387,20,60,0.0,149,59407,0.00033666066288484523,0.0010099819886545357,69
37487,50,349,0.0,960,37537,0.001332019074513147,0.009297493140101766,561
22768,45,281,0.0,748,22813,0.001972559505545084,0.01231753824573708,422
19490,38,216,0.0,531,19528,0.0019459238017206064,0.01106104055714871,277
21469,24,278,0.0,671,21493,0.0011166426278323175,0.01293444377239101,369
17624,43,99,0.0,310,17667,0.0024339163412011094,0.0056036678553234845,168
37146,70,122,20803.0,312,37216,0.0018809114359415306,0.0032781599312123816,120
24970,51,25,901.0,119,25021,0.0020382878382158988,0.0009991607050077935,43
52920,40,50,4255.0,416,52960,0.0007552870090634441,0.0009441087613293052,326
25722,23,112,0.0,223,25745,0.0008933773548261798,0.004350359293066615,88
18311,40,38,0.0,179,18351,0.002179717726554411,0.0020707318402266904,101
19753,80,31,0.0,186,19833,0.00403368123834014,0.0015630514798568042,75
26468,35,111,0.0,251,26503,0.0013206052145040184,0.004188205108855601,105
26527,29,154,0.0,271,26556,0.0010920319325199578,0.005799066124416327,88
37857,28,91,0.0,257,37885,0.0007390787910782631,0.002402006071004355,138
20047,42,18,0.0,132,20089,0.002090696401015481,0.0008960127432923491,72
24147,26,60,159.0,170,24173,0.0010755801927770654,0.002482108137177843,84
24340,39,104,0.0,327,24379,0.0015997374789778088,0.00426596661060749,184
32395,27,38,0.0,150,32422,0.0008327678736660293,0.0011720436740484856,85
23342,38,238,0.0,715,23380,0.0016253207869974338,0.010179640718562874,439
14504,31,139,0.0,226,14535,0.002132782937736498,0.00956312349501204,56
30935,73,141,0.0,480,31008,0.002354231166150671,0.004547213622291021,266
22929,98,193,5317.0,593,23027,0.0042558735397576755,0.008381465236461546,302
19784,18,164,0.0,482,19802,0.000908999091000909,0.008281991718008282,300
47258,121,63,0.0,248,47379,0.0025538740792334156,0.001329703032989299,64
25644,169,97,0.0,378,25813,0.006547088676248402,0.0037577964591484912,112
25244,240,100,23.0,522,25484,0.009417673834562863,0.003924030764401193,182
25316,255,160,863.0,953,25571,0.009972234171522428,0.006257088107621916,538
19091,240,255,3818.0,984,19331,0.01241529150069836,0.013191247219492008,489
44097,24,37,11119.0,572,44121,0.0005439586591419052,0.0008386029328437706,511
25833,25,113,0.0,262,25858,0.0009668187794879728,0.004370020883285637,124
15754,26,152,0.0,306,15780,0.0016476552598225602,0.009632446134347276,128
14734,20,183,0.0,514,14754,0.0013555645926528399,0.012403416022773485,311
60848,34,226,546.0,579,60882,0.0005584573437140698,0.0037120988140994056,319
20402,51,489,18161.0,906,20453,0.0024935217327531414,0.02390847308463306,366
36519,327,764,3251.0,2421,36846,0.008874776095098518,0.020734950876621614,1330
18486,50,214,10468.0,454,18536,0.002697453603798015,0.011545101424255503,190
101302,124,306,226432.0,1026,101426,0.0012225662059038116,0.003016977895214245,596
27471,74,662,0.0,1072,27545,0.0026865129787620257,0.024033399891087312,336
15449,26,15,8122.0,72,15475,0.001680129240710824,0.0009693053311793214,31
35025,49,154,11491.0,370,35074,0.0013970462450818269,0.004390716770257171,167
18615,21,140,11559.0,267,18636,0.0011268512556342563,0.007512341704228375,106
68415,377,496,0.0,1377,68792,0.005480288405628562,0.007210140714036516,504
30515,42,426,0.0,932,30557,0.0013744804791046242,0.013941159145204045,464
45354,97,72,8654.0,247,45451,0.002134166464984269,0.0015841235616378077,78
2199478,1407,1447,7079668.0,5179,2200885,0.00063928828630301,0.0006574627933763009,2325
18173,24,19,14.0,62,18197,0.0013188987195691597,0.0010441281529922515,19
21538,57,18,8276.0,102,21595,0.002639499884232461,0.0008335262792313036,27
24251,13,38,0.0,57,24264,0.0005357731618859216,0.0015661061655126937,6
19789,15,31,14228.0,59,19804,0.0007574227428802262,0.0015653403352858008,13
4060113,2594,2286,3032902.0,8888,4062707,0.0006384905433741592,0.0005626790216473892,4008
3999704,2265,2218,13061838.0,8276,4001969,0.0005659714005780655,0.0005542271816698231,3793
32077,38,26,0.0,112,32115,0.0011832477035653122,0.0008095905340183715,48
11223,312,216,10964.0,591,11535,0.0270481144343303,0.01872561768530559,63
2280425,1281,1391,3506698.0,4670,2281706,0.0005614220236963045,0.0006096315651534422,1998
36093,27,52,0.0,92,36120,0.0007475083056478405,0.0014396456256921372,13
15504,22,294,0.0,426,15526,0.0014169779724333377,0.018935978358881875,110
20196,474,563,3625.0,1747,20670,0.02293178519593614,0.027237542331881956,710
22235,111,156,0.0,397,22346,0.004967331960977356,0.006981115188400609,130
45742,62,249,0.0,489,45804,0.0013535935726137454,0.005436206444851978,178
13265,90,323,0.0,545,13355,0.0067390490453013855,0.024185698240359415,132
32392,412,414,10354.0,2174,32804,0.012559443970247532,0.012620412144860383,1348
26928,353,350,17490.0,2013,27281,0.012939408379458232,0.012829441736006744,1310
28253,32,69,0.0,243,28285,0.0011313417005479936,0.0024394555418066114,142
24633,211,391,0.0,729,24844,0.00849299629689261,0.01573820640798583,127
28154,18,71,0.0,104,28172,0.000638932273179043,0.0025202328553173363,15
25358,42,262,1343.0,442,25400,0.001653543307086614,0.010314960629921259,138
26601,44,131,0.0,214,26645,0.0016513417151435541,0.004916494651904672,39
16854,144,186,27331.0,552,16998,0.008471584892340275,0.010942463819272856,222
19031,31,167,0.0,294,19062,0.0016262721645157905,0.008760885531423774,96
31555,24,55,0.0,135,31579,0.0007599987333354445,0.0017416637638937268,56
17079,70,67,677.0,593,17149,0.004081870663012421,0.003906933348883317,456
16951,148,15,928.0,240,17099,0.00865547692847535,0.0008772442832914206,77
14091,193,58,9.0,371,14284,0.013511621394567347,0.004060487258471017,120
13462,470,131,6161.0,1601,13932,0.03373528567327017,0.009402813666379559,1000
11925,483,181,140.0,1541,12408,0.03892649903288201,0.014587362991618311,877
21934,28,12,1311.0,156,21962,0.0012749294235497677,0.0005463983243784719,116
21840,51,14,22164.0,198,21891,0.0023297245443332877,0.0006395322278561966,133
23377,206,241,0.0,712,23583,0.008735105796548362,0.010219225713437646,265
25414,191,173,15.0,542,25605,0.007459480570201133,0.0067564928724858425,178
32562,47,74,0.0,440,32609,0.0014413198810144438,0.002269312153086571,319
10876,20,97,0.0,201,10896,0.0018355359765051395,0.008902349486049926,84
40309,80,396,0.0,823,40389,0.0019807373294708957,0.009804649780880933,347
34189,233,343,0.0,1300,34422,0.006768926849108128,0.009964557550403812,724
25129,108,135,0.0,348,25237,0.004279430994175219,0.005349288742719023,105
15451,40,38,0.0,140,15491,0.0025821444709831515,0.002453037247433994,62
13405,79,32,1243.0,360,13484,0.005858795609611391,0.002373183031741323,249
29751,113,279,0.0,711,29864,0.0037838199839271363,0.009342351995713902,319
18069,39,32,3.0,199,18108,0.0021537442014579193,0.0017671747294013696,128
2845,37,16,3257.0,330,2882,0.012838306731436502,0.005551700208188758,277
2792,20,78,3257.0,367,2812,0.007112375533428165,0.027738264580369845,269
23842,205,295,0.0,1082,24047,0.008524971929970475,0.012267642533372146,582
14636,19,371,6128.0,935,14655,0.0012964858410098943,0.025315591948140568,545
17873,15,39,17712.0,416,17888,0.0008385509838998211,0.002180232558139535,362
25599,27,474,821.0,947,25626,0.0010536174198080075,0.018496839147740574,446
31761,37,93,0.0,511,31798,0.0011635951946663311,0.0029247122460532107,381
27074,671,587,21031.0,1882,27745,0.02418453775455037,0.021156965218958372,624
9520,10,30,4158.0,158,9530,0.001049317943336831,0.0031479538300104933,118
5942,8,57,8317.0,189,5950,0.0013445378151260505,0.00957983193277311,124
19276,142,430,0.0,925,19418,0.007312802554331033,0.022144402101143268,353
14574,23,73,0.0,250,14597,0.001575666232787559,0.005001027608412687,154
25309,694,709,5294.0,2269,26003,0.02668922816598085,0.02726608468253663,866
23409,165,207,5862.0,702,23574,0.0069992364469330616,0.00878086026978875,330
13916,53,121,0.0,353,13969,0.003794115541556303,0.00866203736845873,179
19759,372,399,6062.0,1329,20131,0.018478962793701256,0.019820177835179573,558
30539,67,243,0.0,961,30606,0.0021891132457688037,0.007939619682415213,651
19069,171,90,0.0,418,19240,0.008887733887733888,0.004677754677754678,157
22499,166,23,0.0,364,22665,0.007324067946172513,0.001014780498566071,175
29056,185,106,1881.0,635,29241,0.006326733011866899,0.0036250470230156286,344
14172,20,43,377.0,193,14192,0.0014092446448703494,0.0030298759864712515,130
22586,67,98,1149.0,364,22653,0.0029576656513486074,0.0043261378183905,199
16086,17,22,8613.0,177,16103,0.0010557039061044526,0.0013662050549587033,138
19222,24,191,0.0,373,19246,0.0012470123662059649,0.009924140081055804,158
15969,30,13,0.0,176,15999,0.0018751171948246765,0.0008125507844240265,133
13706,54,211,0.0,373,13760,0.003924418604651163,0.015334302325581394,108
13904,9,206,5050.0,342,13913,0.0006468770214906922,0.014806296269675842,127
11260,41,116,279.0,261,11301,0.0036279975223431553,0.010264578355897709,104
11784,719,601,8042.0,1660,12503,0.05750619851235703,0.0480684635687435,340
10421,700,526,7952.0,1513,11121,0.06294397985792645,0.04729790486467044,287
10334,716,574,0.0,1568,11050,0.06479638009049773,0.05194570135746606,278
8444,175,226,3151.0,511,8619,0.020303979579997678,0.02622113934331129,110
25299,91,630,90.0,1222,25390,0.003584088223710122,0.024812918471839307,501
30569,637,555,1200.0,1856,31206,0.02041274113952445,0.017785041338204192,664
12964,202,370,1364.0,739,13166,0.01534254898982227,0.02810268874373386,167
15541,716,903,935.0,1853,16257,0.04404256627914129,0.05554530356154272,234
10435,49,178,5574.0,349,10484,0.004673788630293781,0.016978252575352917,122
11379,61,92,0.0,245,11440,0.0053321678321678325,0.008041958041958041,92
12799,29,21,6214.0,185,12828,0.0022606797630183974,0.001637043966323667,135
10277,24,13,10723.0,167,10301,0.0023298708863217165,0.0012620133967575964,130
30453,690,707,8805.0,2355,31143,0.02215586167035931,0.022701730726005846,958
11312,202,209,467.0,697,11514,0.017543859649122806,0.018151815181518153,286
19109,62,124,0.0,355,19171,0.0032340514318501905,0.006468102863700381,169
21132,24,111,26.0,306,21156,0.0011344299489506524,0.005246738513896767,171
32866,890,1338,158.0,3062,33756,0.026365683137812537,0.03963739779594739,834
21284,21,40,0.0,217,21305,0.000985684111710866,0.0018774935461159353,156
21363,21,19,0.0,181,21384,0.0009820426487093155,0.0008885147774036663,141
13803,15,28,0.0,126,13818,0.0010855405992184109,0.002026342451874367,83
21456,20,17,1810.0,200,21476,0.0009312721177127957,0.0007915813000558763,163
17529,29,35,2.0,174,17558,0.0016516687549834833,0.0019933933249800663,110
16328,14,60,9.0,177,16342,0.0008566882878472647,0.0036715212336311345,103
20372,18,121,1931.0,268,20390,0.0008827856792545365,0.005934281510544384,129
19446,18,21,0.0,161,19464,0.0009247842170160296,0.0010789149198520344,122
17082,13,49,1063.0,176,17095,0.0007604562737642585,0.002866335185726821,114
19242,42,192,0.0,358,19284,0.0021779713752333543,0.009956440572495333,124
17193,19,60,0.0,189,17212,0.0011038810132465722,0.0034859400418312805,110
15644,15,22,3.0,140,15659,0.000957915575707261,0.0014049428443706495,103
20036,21,64,0.0,207,20057,0.0010470160043874956,0.00319090591813332,122
14218,19,47,0.0,155,14237,0.0013345508182903702,0.0033012572873498632,89
16935,43,71,4.0,228,16978,0.0025326893627046765,0.004181882436093768,114
18617,16,60,0.0,194,18633,0.0008586915687221596,0.0032200933827080985,118
14337,41,36,0.0,175,14378,0.0028515788009458895,0.0025038252886354154,98
14937,14,27,143.0,140,14951,0.0009363922145675874,0.001805899270951776,99
14109,43,25,92.0,161,14152,0.003038439796495195,0.0017665347654041831,93
18167,32,138,0.0,285,18199,0.001758338370240123,0.007582834221660531,115
20633,41,32,0.0,229,20674,0.001983167263229177,0.0015478378639837477,156
17216,28,85,571.0,275,17244,0.0016237531895151936,0.004929250753885409,162
13316,17,13,163.0,118,13333,0.001275031875796895,0.0009750243756093903,88
14901,14,14,35.0,124,14915,0.0009386523633925578,0.0009386523633925578,96
17383,23,21,10.0,158,17406,0.0013213834310008042,0.001206480523957256,114
12857,20,8,170.0,121,12877,0.0015531567911780694,0.0006212627164712278,93
14971,28,13,0.0,141,14999,0.0018667911194079605,0.0008667244482965531,100
13046,28,197,0.0,336,13074,0.0021416551935138444,0.015068074040079546,111
15465,36,31,0.0,171,15501,0.002322430810915425,0.0019998709760660604,104
18206,26,113,0.0,258,18232,0.0014260640631856077,0.006197893813075911,119
14376,12,23,0.0,127,14388,0.0008340283569641367,0.001598554350847929,92
12439,268,159,0.0,523,12707,0.021090737388840798,0.012512788226961518,96
17206,16,185,2.0,305,17222,0.000929044245732203,0.010742074091278597,104
17691,25,193,0.0,499,17716,0.0014111537593136149,0.010894107021901106,281
13576,18,13,53.0,121,13594,0.0013241135795203766,0.0009563042518758275,90
14130,31,13,293.0,137,14161,0.0021891109384930443,0.0009180142645293411,93
13534,43,53,235.0,182,13577,0.00316712086617073,0.0039036606024895042,86
16561,50,393,2525.0,766,16611,0.0030100535789537052,0.023659021130576125,323
13520,30,181,3915.0,342,13550,0.002214022140221402,0.013357933579335794,131
12990,39,88,0.0,217,13029,0.0029933225880727607,0.006754163788471871,90
13947,25,32,0.0,150,13972,0.0017892928714572,0.002290294875465216,93
13487,12,14,32.0,117,13499,0.0008889547373879547,0.0010371138602859472,91
12463,37,26,187.0,148,12500,0.00296,0.00208,85
11396,17,34,0.0,119,11413,0.0014895294839218434,0.002979058967843687,68
12595,16,23,67.0,112,12611,0.0012687336452303544,0.0018238046150186346,73
13150,22,71,0.0,174,13172,0.0016702095353780747,0.005390221682356514,81
13122,49,75,16.0,215,13171,0.0037202945865917546,0.005694328448864931,91
13356,18,47,2.0,149,13374,0.0013458950201884253,0.0035142814416031106,84
10601,13,212,3339.0,307,10614,0.0012247974373469004,0.019973619747503297,82
13331,18,42,0.0,142,13349,0.0013484156116563039,0.003146303093864709,82
15084,228,528,869.0,1150,15312,0.014890282131661442,0.034482758620689655,394
11376,20,13,0.0,106,11396,0.001755001755001755,0.0011407511407511407,73
10860,19,7,0.0,85,10879,0.0017464840518430003,0.0006434414927842633,59
10923,20,19,0.0,106,10943,0.0018276523805172257,0.0017362697614913642,67
11143,16,81,0.0,162,11159,0.0014338202347880635,0.007258714938614571,65
10719,13,54,0.0,130,10732,0.0012113306000745435,0.005031680954155795,63
10816,23,79,0.0,171,10839,0.0021219669711227975,0.007288495248639173,69
11381,13,61,2326.0,190,11394,0.0011409513779182027,0.005353694927154643,116
9549,238,402,1446.0,908,9787,0.0243179728210892,0.0410748952692347,268
10737,471,256,332.0,912,11208,0.04202355460385439,0.022840827980014276,185
12609,41,164,0.0,393,12650,0.003241106719367589,0.012964426877470356,188
22955,131,207,13237.0,933,23086,0.005674434722342545,0.008966473187213029,595
19731,22,206,6429.0,517,19753,0.001113754872677568,0.010428795625980864,289
23446,35,228,0.0,548,23481,0.0014905668412759253,0.009709978280311742,285
22250,23,195,128.0,492,22273,0.0010326404166479594,0.008754994836797916,274
15760,44,198,16.0,468,15804,0.0027841052898000505,0.012528473804100227,226
17728,60,169,126.0,447,17788,0.0033730604902181245,0.009500787047447718,218
21134,22,221,10514.0,543,21156,0.0010398941198714313,0.010446209113253923,300
16206,44,205,2034.0,561,16250,0.0027076923076923077,0.012615384615384615,312
21161,21,194,8963.0,511,21182,0.0009914077990746861,0.009158719667642338,296
17925,18,198,6322.0,491,17943,0.0010031767262999498,0.011034943989299448,275
14675,23,216,3097.0,459,14698,0.0015648387535719145,0.014695876990066676,220
12927,357,83,0.0,682,13284,0.02687443541102078,0.006248118036735923,242
14542,170,196,254.0,567,14712,0.011555193039695487,0.013322457857531268,201
25751,211,360,0.0,1111,25962,0.008127262922733226,0.013866420152530621,540
18164,35,24,3940.0,228,18199,0.0019231825924501346,0.0013187537776800924,169
16830,148,194,0.0,537,16978,0.00871716338791377,0.011426552008481564,195
18518,198,240,3694.0,752,18716,0.010579183586236376,0.012823252831801668,314
19210,216,223,179.0,767,19426,0.011119118706887676,0.01147946051683311,328
13718,100,299,4214.0,745,13818,0.007236937328122739,0.021638442611086987,346
18450,505,411,15422.0,1211,18955,0.02664204695331047,0.021682933262991297,295
15455,197,346,13144.0,1004,15652,0.01258625095834398,0.022105801175568617,461
13213,32,85,20288.0,333,13245,0.0024160060400151002,0.006417516043790109,216
12080,14,40,5111.0,257,12094,0.001157598809326939,0.00330742516950554,203
12098,23,22,5840.0,248,12121,0.0018975332068311196,0.0018150317630558535,203
11394,36,83,322.0,265,11430,0.0031496062992125984,0.00726159230096238,146
10933,36,23,19006.0,205,10969,0.0032819764791685658,0.0020968183061354727,146
25223,42,43,2.0,477,25265,0.0016623787848802692,0.0017019592321393232,392
8681,24,241,8394.0,448,8705,0.0027570361860999423,0.02768523836875359,183
12832,40,236,3.0,445,12872,0.003107520198881293,0.018334369173399628,169
9494,266,313,4001.0,754,9760,0.02725409836065574,0.03206967213114754,175
12254,21,66,0.0,203,12275,0.0017107942973523423,0.0053767820773930755,116
25160,542,430,5321.0,1829,25702,0.02108785308536301,0.016730215547428217,857
11340,233,445,3.0,844,11573,0.020133068348742764,0.03845156830553875,166
15789,159,795,2.0,1274,15948,0.0099699021820918,0.04984951091045899,320
11470,484,199,0.0,837,11954,0.04048853940103731,0.01664714739836038,154
18446,187,899,4474.0,1968,18633,0.01003595770944024,0.048247732517576344,882
14312,190,347,0.0,923,14502,0.013101641152944422,0.023927734105640603,386
14254,25,580,23.0,1039,14279,0.0017508228867567756,0.0406190909727572,434
14830,146,536,3596.0,1103,14976,0.009748931623931624,0.03579059829059829,421
13838,368,520,11331.0,1339,14206,0.025904547374348868,0.0366042517246234,451
19345,206,33,0.0,519,19551,0.010536545445245767,0.0016878932023937393,280
13833,61,589,0.0,980,13894,0.004390384338563409,0.04239239959694832,330
16459,238,41,0.0,523,16697,0.014254057615140444,0.002455530933700665,244
17684,196,36,6624.0,535,17880,0.010961968680089485,0.0020134228187919465,303
15765,202,28,3938.0,491,15967,0.012651092879063068,0.0017536168347216134,261
15327,122,231,0.0,500,15449,0.007896951258981164,0.014952424105120073,147
12015,61,247,2846.0,778,12076,0.005051341503809209,0.02045379264657171,470
10644,26,293,4726.0,414,10670,0.002436738519212746,0.0274601686972821,95
32491,53,128,78.0,527,32544,0.0016285644051130777,0.003933136676499509,346
27314,31,212,3370.0,690,27345,0.0011336624611446335,0.007752788443956848,447
29346,26,19,2.0,283,29372,0.000885196786054746,0.0006468745744246221,238
25999,22,24,812.0,277,26021,0.0008454709657584259,0.0009223319626455555,231
25070,174,69,0.0,457,25244,0.006892726984630011,0.0027333227697670733,214
25584,24,71,0.0,292,25608,0.0009372071227741331,0.0027725710715401438,197
28393,39,39,1176.0,339,28432,0.0013716938660664041,0.0013716938660664041,261
24296,35,189,0.0,435,24331,0.001438494102174181,0.007767868151740578,211
23006,29,200,0.0,548,23035,0.0012589537660082483,0.008682439765574127,319
25898,30,315,1541.0,550,25928,0.0011570502931194076,0.01214902807775378,205
27720,27,72,7178.0,341,27747,0.0009730781706130393,0.0025948751216347712,242
24186,177,29,0.0,407,24363,0.007265115133604236,0.001190329598161146,201
24583,68,76,0.0,335,24651,0.002758508782605168,0.003083039227617541,191
22692,19,15,0.0,209,22711,0.0008365990048874994,0.0006604728985953943,175
23055,23,12,0.0,214,23078,0.0009966201577259728,0.0005199757344657249,179
19933,27,23,0.0,195,19960,0.0013527054108216433,0.0011523046092184368,145
14671,757,591,1613.0,1958,15428,0.049066632097485095,0.03830697433238268,610
16964,628,200,710.0,1257,17592,0.035698044565711684,0.011368804001819008,429
41894,1339,1419,20248.0,4549,43233,0.030971711424143594,0.032822149746721256,1791
14529,154,122,15134.0,631,14683,0.010488319825648709,0.00830892869304638,355
12275,24,70,0.0,264,12299,0.0019513781608260835,0.005691519635742743,170
13293,23,6,9486.0,246,13316,0.0017272454190447582,0.0004505857614899369,217
11761,23,22,1088.0,214,11784,0.0019517990495587236,0.00186693822131704,169
13154,22,12,62.0,305,13176,0.0016697024893746206,0.0009107468123861566,271
13280,39,19,7417.0,277,13319,0.002928147758840754,0.0014265335235378032,219
13145,43,154,1632.0,387,13188,0.0032605398847437065,0.01167728237791932,190
13292,26,7,13612.0,252,13318,0.0019522450818441207,0.0005256044451118786,219
12997,29,217,362.0,467,13026,0.0022263165975740826,0.01665898971288193,221
13206,81,32,1846.0,328,13287,0.006096184240234816,0.0024083690825619027,215
12365,38,21,2.0,277,12403,0.0030637748931710072,0.0016931387567523987,218
12019,29,37,5345.0,280,12048,0.002407038512616202,0.0030710491367861885,214
14331,29,233,0.0,617,14360,0.00201949860724234,0.016225626740947074,355
19040,493,1283,451.0,2520,19533,0.025239338555265448,0.06568371473915938,744
30516,659,270,11595.0,1849,31175,0.021138732959101843,0.008660785886126704,920
23619,907,1058,0.0,2515,24526,0.036981162847590315,0.04313789447932806,550
13681,46,46,44.0,217,13727,0.00335105995483354,0.00335105995483354,125
8986,40,88,8447.0,213,9026,0.0044316419233325945,0.009749612231331709,85
12696,93,225,0.0,428,12789,0.007271874266948158,0.017593244194229415,110
13757,372,244,0.0,895,14129,0.026328827234765376,0.017269445820652558,279
20551,338,134,199.0,777,20889,0.016180764995930873,0.006414859495428216,305
13726,280,70,6923.0,691,14006,0.01999143224332429,0.004997858060831073,341
30772,764,436,2446.0,2146,31536,0.024226281075596143,0.013825469304921359,946
17059,206,310,8323.0,1069,17265,0.011931653634520707,0.017955401100492326,553
16891,61,300,3316.0,826,16952,0.003598395469561114,0.017697026899480887,465
13132,612,628,0.0,1803,13744,0.04452852153667055,0.04569266589057043,563
21726,540,742,1831.0,2078,22266,0.024252223120452707,0.033324351028473906,796
14657,385,634,0.0,1779,15042,0.02559500066480521,0.04214865044541949,760
14445,24,454,3867.0,938,14469,0.0016587186398507154,0.0313774276038427,460
23888,215,759,2937.0,1302,24103,0.008920051445878107,0.031489856034518524,328
12302,21,272,0.0,404,12323,0.0017041304877059157,0.022072547269333765,111
19376,190,529,3665.0,969,19566,0.009710722682203823,0.02703669630992538,250
11107,13,69,144.0,229,11120,0.0011690647482014388,0.0062050359712230215,147
12333,79,376,62.0,593,12412,0.006364808250080567,0.03029326458266194,138
12579,19,19,1137.0,211,12598,0.0015081759009366567,0.0015081759009366567,173
10418,15,371,1841.0,570,10433,0.0014377456148758746,0.0355602415412633,184
10859,12,76,2229.0,213,10871,0.0011038542912335573,0.006991077177812529,125
8976,25,79,5123.0,205,9001,0.002777469170092212,0.00877680257749139,101
11738,11,216,722.0,401,11749,0.0009362498936079666,0.0183845433653928,174
12193,46,423,25.0,661,12239,0.003758476999754882,0.03456164719339815,192
13800,20,83,542.0,313,13820,0.001447178002894356,0.006005788712011577,210
11801,24,211,0.0,415,11825,0.002029598308668076,0.01784355179704017,180
13125,30,287,131.0,555,13155,0.002280501710376283,0.021816799695933104,238
8977,12,188,2789.0,382,8989,0.0013349649571698743,0.020914450995661363,182
8322,25,204,12051.0,433,8347,0.0029950880555888342,0.024439918533604887,204
13933,71,32,1892.0,538,14004,0.005069980005712653,0.0022850614110254213,435
11853,74,239,5238.0,715,11927,0.006204410161817725,0.020038567955059948,402
34059,381,259,1682.0,1595,34440,0.011062717770034843,0.007520325203252033,955
20965,916,1314,960.0,3104,21881,0.04186280334536813,0.060052099995429827,874
19223,201,452,1052.0,1350,19424,0.010348023064250412,0.02327018121911038,697
13126,28,349,320.0,587,13154,0.002128630074502053,0.02653185342861487,210
13141,21,215,888.0,422,13162,0.0015955022033125664,0.01633490351010485,186
7235,10,33,4096.0,181,7245,0.0013802622498274672,0.004554865424430642,138
10966,18,408,8814.0,758,10984,0.0016387472687545521,0.037144938091769844,332
15134,386,221,1675.0,1003,15520,0.024871134020618555,0.014239690721649484,396
25846,424,552,5612.0,1576,26270,0.01614008374571755,0.02101256185763228,600
15965,22,105,0.0,294,15987,0.0013761180959529617,0.0065678363670482265,167
20403,37,361,0.0,637,20440,0.0018101761252446184,0.017661448140900194,239
22911,28,323,0.0,615,22939,0.0012206286237412267,0.014080823052443438,264
29144,652,732,32.0,2092,29796,0.02188213182977581,0.024567055980668547,708
16603,143,273,6355.0,911,16746,0.00853935268123731,0.016302400573271227,495
18120,360,283,3817.0,1140,18480,0.01948051948051948,0.015313852813852814,497
16267,386,440,3524.0,1402,16653,0.023179006785564164,0.02642166576592806,576
22874,381,212,1517.0,964,23255,0.016383573425069877,0.009116319071167492,371
10494,242,243,4413.0,851,10736,0.022540983606557378,0.02263412816691505,366
14222,173,398,1675.0,926,14395,0.012018061827023273,0.027648489058700938,355
17538,183,184,3504.0,651,17721,0.010326730997122058,0.010383161221150048,284
17494,798,393,1048.0,2111,18292,0.043625628690137766,0.021484802099278374,920
19173,1436,963,10.0,3271,20609,0.06967829589014508,0.046727158037750495,872
25012,1153,605,12010.0,3067,26165,0.04406650105102236,0.023122491878463595,1309
23110,380,176,3325.0,1053,23490,0.016177096636866752,0.0074925500212856535,497
11413,143,294,4148.0,753,11556,0.012374524056767047,0.02544132917964694,316
28046,31,337,1873.0,962,28077,0.0011041065640916051,0.012002706841899063,594
20493,11,222,3019.0,461,20504,0.000536480686695279,0.010827155676941085,228
21855,26,200,3239.0,685,21881,0.0011882455098030254,0.009140350075407888,459
19057,22,22,6118.0,361,19079,0.0011531002673096074,0.0011531002673096074,317
12139,31,277,9.0,665,12170,0.0025472473294987676,0.02276088742810189,357
12341,134,188,0.0,507,12475,0.010741482965931864,0.015070140280561122,185
25799,267,1179,3080.0,2178,26066,0.01024322872707742,0.045231335839791297,732
25987,214,376,0.0,1336,26201,0.008167627189801916,0.014350597305446357,746
15399,210,368,2245.0,1137,15609,0.013453776667307323,0.023576141969376643,559
12207,48,790,2390.0,1328,12255,0.003916768665850673,0.06446348429212566,490
29084,218,449,9830.0,1396,29302,0.007439765203740359,0.015323186130639547,729
17839,418,944,522.0,1881,18257,0.022895327819466505,0.051706194884154025,519
29588,375,203,0.0,1071,29963,0.012515435704034976,0.006775022527784267,493
23301,46,202,826.0,671,23347,0.0019702745534758213,0.008652075213089477,423
24758,51,361,99.0,1177,24809,0.0020557055907130476,0.01455117094602765,765
19390,116,324,0.0,796,19506,0.005946888136983492,0.016610273761919408,356
19928,29,378,1281.0,1080,19957,0.0014531242170666935,0.018940722553490004,673
18859,34,415,1001.0,1058,18893,0.0017996083205419997,0.021965807441909704,609
19487,50,208,796.0,627,19537,0.00255924655781338,0.01064646568050366,369
20674,414,650,7044.0,1540,21088,0.019632018209408193,0.03082321699544765,476
28064,247,310,7271.0,1707,28311,0.00872452403659355,0.01094980749531984,1150
20395,23,223,98.0,707,20418,0.001126457047703007,0.01092173572338133,461
19191,16,198,9940.0,666,19207,0.0008330296246160255,0.010308741604623315,452
22212,34,325,2.0,796,22246,0.0015283646498246875,0.014609367976265396,437
14378,53,210,320.0,543,14431,0.0036726491580625045,0.014552006097983508,280
15305,29,375,10871.0,954,15334,0.0018912221207773574,0.0244554584583279,550
16417,385,206,3366.0,1284,16802,0.022913938816807523,0.012260445185097012,693
14152,516,304,3860.0,1187,14668,0.03517862012544314,0.02072538860103627,367
23266,66,290,2781.0,1206,23332,0.0028287330704611694,0.01242928167323847,850
23582,63,289,683.0,739,23645,0.002664411080566716,0.012222457179107634,387
26833,215,556,2273.0,1516,27048,0.007948831706595681,0.020556048506359066,745
32750,465,971,9517.0,2489,33215,0.01399969893120578,0.029233779918711424,1053
19437,36,82,1715.0,462,19473,0.0018487136034509321,0.004210958763416012,344
21588,66,340,359.0,789,21654,0.003047935716264893,0.015701487023182782,383
20319,35,544,1986.0,969,20354,0.0017195637221185025,0.02672693328092758,390
15995,35,212,0.0,503,16030,0.002183406113537118,0.0132252027448534,256
16393,19,240,3862.0,519,16412,0.001157689495491104,0.014623446258834999,260
11447,25,217,2261.0,477,11472,0.002179218967921897,0.018915620641562065,235
23984,561,534,5.0,2022,24545,0.02285597881442249,0.021755958443674884,927
29157,64,718,581.0,1439,29221,0.0021902056740015744,0.02457136990520516,657
15259,20,26,6172.0,470,15279,0.0013089861901956934,0.0017016820472544015,424
18034,28,45,7078.0,538,18062,0.0015502159229321226,0.002491418447569483,465
16172,341,454,448.0,1306,16513,0.02065039665717919,0.027493489977593412,511
16997,238,390,0.0,1275,17235,0.013809109370467074,0.022628372497824196,647
16197,26,54,529.0,500,16223,0.0016026628860260125,0.003328607532515564,420
11816,70,246,34.0,675,11886,0.005889281507656066,0.020696617869762745,359
25071,96,267,2046.0,867,25167,0.003814519012993205,0.010609131004887352,504
20930,26,24,4249.0,363,20956,0.0012406947890818859,0.0011452567283832794,313
11516,17,95,3767.0,243,11533,0.0014740310413595768,0.008237232289950576,131
20334,588,689,471.0,1833,20922,0.02810438772583883,0.03293184208010706,556
22016,536,607,5698.0,1882,22552,0.023767293366442,0.026915572898190847,739
17569,46,210,2802.0,739,17615,0.0026114107294919102,0.011921657678115243,483
22480,62,225,2255.0,776,22542,0.002750421435542543,0.009981368112856001,489
14994,53,145,1360.0,533,15047,0.003522296803349505,0.009636472386522231,335
22653,597,1037,0.0,2218,23250,0.02567741935483871,0.04460215053763441,584
12769,35,206,1914.0,532,12804,0.002733520774757888,0.016088722274289285,291
11213,25,205,1317.0,438,11238,0.002224595123687489,0.01824168001423741,208
16149,408,302,1692.0,1261,16557,0.024642145316180468,0.018240019327172795,551
18617,550,417,3806.0,1255,19167,0.02869515312777169,0.021756143371419626,288
16437,554,627,606.0,1786,16991,0.03260549702783827,0.0369018892354776,605
7364,356,148,3052.0,756,7720,0.0461139896373057,0.01917098445595855,252
12752,18,75,8965.0,343,12770,0.0014095536413469068,0.005873140172278779,250
16834,367,573,7078.0,1590,17201,0.02133596883902099,0.0333120167432126,650
21456,396,157,0.0,1011,21852,0.018121911037891267,0.007184697052901336,458
17306,352,184,0.0,895,17658,0.019934307396081097,0.010420206138860574,359
20755,501,836,1774.0,2184,21256,0.023569815581482877,0.039330071509220924,847
11540,107,230,1643.0,605,11647,0.009186915085429724,0.01974757448269941,268
17575,27,37,0.0,306,17602,0.0015339166003863198,0.0021020338597886605,242
18865,25,260,3284.0,744,18890,0.0013234515616728428,0.013763896241397565,459
17204,371,587,12222.0,1854,17575,0.021109530583214794,0.03339971550497866,896
15878,366,448,7384.0,1300,16244,0.022531396207830585,0.02757941393745383,486
12763,25,76,15.0,256,12788,0.001954957772912105,0.0059430716296528,155
17367,10,1,35440.0,157,17377,0.0005754733268113023,5.754733268113023e-05,146
19441,59,179,11477.0,597,19500,0.0030256410256410257,0.009179487179487179,359
17298,13,11,14437.0,162,17311,0.0007509675928600312,0.000635434117035411,138
17223,14,145,3350.0,308,17237,0.0008122063004003016,0.008412136682717411,149
15297,7,23,0.0,134,15304,0.0004573967590172504,0.0015028750653423941,104
20972,123,343,3537.0,1137,21095,0.005830765584261674,0.016259777198388243,671
16480,31,33,4677.0,218,16511,0.0018775361879958816,0.001998667554963358,154
8202,20,3,17243.0,103,8222,0.0024324981756263684,0.00036487472634395525,80
15888,14,21,13174.0,166,15902,0.0008803924034712615,0.0013205886052068921,131
14679,8,24,0.0,136,14687,0.0005446993940219242,0.0016340981820657725,104
15548,30,89,4081.0,441,15578,0.0019257927846963667,0.005713185261265887,322
13280,28,37,23263.0,96,13308,0.0021039975954313195,0.002780282536819958,31
12476,74,237,0.0,494,12550,0.005896414342629482,0.018884462151394422,183
3950650,1886,1769,45488001.0,7566,3952536,0.00047716200434354044,0.00044756075592986374,3911
17271,69,16,12548.0,162,17340,0.00397923875432526,0.000922722029988466,77
660216,175,310,866520.0,1075,660391,0.00026499452597022067,0.00046941887457581946,590
18429,48,13,8146.0,102,18477,0.002597824322130216,0.0007035774205769335,41
1018096,406,343,5728713.0,1694,1018502,0.0003986246467851806,0.00033676909814610084,945
32104,69,302,10251.0,477,32173,0.0021446554564386287,0.0093867528673111,106
604327,592,267,612137.0,1295,604919,0.00097864342168125,0.0004413814080893475,436
1319563,292,277,6263116.0,1190,1319855,0.00022123642369805774,0.00020987153891904793,621
36511,45,75,0.0,218,36556,0.0012309880730933362,0.002051646788488894,98
28598,28,77,0.0,141,28626,0.000978131768322504,0.0026898623628868862,36
81093,121,146,0.0,439,81214,0.0014898909055089025,0.0017977196049942129,172
19689,38,64,2.0,226,19727,0.0019262939118973995,0.0032442844831956203,124
27146,101,465,0.0,781,27247,0.003706830109736852,0.017066099020075606,215
4075047,1779,1915,8175620.0,7449,4076826,0.00043636888108543266,0.00046972816598010313,3755
49846,145,294,17574.0,1424,49991,0.0029005220939769157,0.005881058590546298,985
30867,69,71,0.0,434,30936,0.002230411171450737,0.002295060770623222,294
21276,164,168,0.0,673,21440,0.007649253731343284,0.007835820895522387,341
20144,143,115,0.0,568,20287,0.007048849016611623,0.005668654803568788,310
44774,163,83,0.0,710,44937,0.0036273004428422012,0.0018470302868460289,464
24753,221,79,0.0,515,24974,0.008849203171298151,0.003163289821414271,215
37948,17,19,0.0,52,37965,0.00044778085078361646,0.0005004609508758067,16
31116,164,267,0.0,652,31280,0.005242966751918159,0.008535805626598466,221
12983,51,38,13.0,138,13034,0.003912843332821851,0.0029154518950437317,49
4139253,18404,17842,7813690.0,46982,4157657,0.004426531577761224,0.00429135929202433,10736
5948,15,9,11886.0,259,5963,0.0025155123260103976,0.0015093073956062384,235
85857,94,59,23103.0,592,85951,0.001093646379914137,0.0006864376214354691,439
13663,37,252,348.0,381,13700,0.0027007299270072993,0.018394160583941607,92
1359888,467,442,11034.0,1863,1360355,0.0003432927434382937,0.00032491518757971267,954
1206203,541,702,1778709.0,2186,1206744,0.0004483138097226918,0.0005817306736142878,943
3052038,1991,2628,10414090.0,8528,3054029,0.0006519257020807596,0.0008605026343888679,3909
40560,82,26,0.0,161,40642,0.002017617243245903,0.0006397322966389449,53
2072578,1574,1800,548330.0,5773,2074152,0.0007588643455253038,0.0008678245374495215,2399
813614,385,635,185864.0,1836,813999,0.00047297355402156513,0.0007800992384511528,816
541591,178,163,1500540.0,769,541769,0.00032855331331250033,0.0003008662363479638,428
7170,6,77,15701.0,93,7176,0.0008361204013377926,0.010730211817168338,10
11233,34,16,24735.0,52,11267,0.0030176621993432146,0.0014200763291026893,2
11933,9,16,2327.0,34,11942,0.0007536426059286551,0.001339809077206498,9
2032789,4022,3495,14200017.0,11363,2036811,0.001974655478588833,0.0017159176771924347,3846
892984,872,832,2700371.0,2814,893856,0.0009755486342319121,0.0009307986968818243,1110
344036,514,130,183351.0,935,344550,0.001491800899724278,0.0003773037295022493,291
17573,53,43,0.0,240,17626,0.003006921593101101,0.002439577896289572,144
385577,217,428,793394.0,1214,385794,0.00056247634748078,0.0011094003535565612,569
368421,1234,452,455346.0,2737,369655,0.003338247825675292,0.0012227617643478378,1051
96757,203,111,493711.0,414,96960,0.0020936468646864685,0.0011448019801980197,100
15876,14,5,200.0,47,15890,0.000881057268722467,0.00031466331025802394,28
42549,62,49,0.0,210,42611,0.001455023350777968,0.0011499378094858136,99
18218,30,40,0.0,86,18248,0.0016440157825515125,0.0021920210434020165,16
29620,85,217,0.0,472,29705,0.002861471132805925,0.0073051674802221845,170
39051,360,574,0.0,1304,39411,0.009134505594884677,0.014564461698510568,370
10964,15,123,0.0,239,10979,0.0013662446488751253,0.011203206120776027,101
30832,191,228,0.0,547,31023,0.00615672243174419,0.0073493859394642685,128
23712,327,90,10049.0,705,24039,0.01360289529514539,0.0037439161362785474,288
70269,404,185,62156.0,795,70673,0.005716468807040878,0.002617689924016244,206
16251,14,18,3782.0,78,16265,0.0008607439286812173,0.0011066707654472795,46
11491,59,100,0.0,351,11550,0.005108225108225109,0.008658008658008658,192
24041,34,78,0.0,243,24075,0.0014122533748701972,0.0032398753894080996,131
71672,17,30,0.0,73,71689,0.00023713540431586437,0.00041847424291034885,26
32960,79,518,0.0,1233,33039,0.0023911135324919037,0.015678440630769695,636
61300,36,52,0.0,170,61336,0.0005869310029998696,0.0008477892265553672,82
24107,50,103,0.0,207,24157,0.002069793434615225,0.004263774475307364,54
26604,119,94,685.0,320,26723,0.004453092841372601,0.003517569135201886,107
21533,143,85,0.0,353,21676,0.006597158147259642,0.0039213877099095774,125
20076,59,89,0.0,215,20135,0.002930221008194686,0.004420163893717408,67
15131,17,206,0.0,280,15148,0.0011222603644045418,0.013599155003960918,57
12922,65,78,0.0,191,12987,0.005005005005005005,0.006006006006006006,48
24012,427,72,3631.0,614,24439,0.017472073325422482,0.0029461107246614017,115
6660,95,418,10998.0,1112,6755,0.014063656550703183,0.061880088823094,599
2293,4,87,12935.0,278,2297,0.0017414018284719198,0.037875489769264255,187
2151,2,88,22366.0,249,2153,0.0009289363678588017,0.04087320018578727,159
2162,2,77,16823.0,257,2164,0.0009242144177449168,0.0355822550831793,178
2361,4,86,16892.0,287,2365,0.0016913319238900633,0.03636363636363636,197
2159,4,80,15548.0,258,2163,0.0018492834026814608,0.03698566805362922,174
2150,2,89,17669.0,261,2152,0.0009293680297397769,0.041356877323420076,170
2304,6,76,11484.0,289,2310,0.0025974025974025974,0.0329004329004329,207
2142,2,90,14505.0,268,2144,0.0009328358208955224,0.04197761194029851,176
2127,2,105,9086.0,281,2129,0.0009394081728511038,0.04931892907468295,174
2142,6,90,12628.0,265,2148,0.002793296089385475,0.04189944134078212,169
2163,4,80,14603.0,262,2167,0.0018458698661744347,0.03691739732348869,178
1999,3,78,14948.0,235,2002,0.0014985014985014985,0.03896103896103896,154
