match,insertion,deletion,soft_clipping,NM,lengths,INS_readLength,DEL_readLength,NM_INS_DEL
55544,137,201,368.0,1174,55681,0.0024604443167328175,0.0036098489610459582,836
166303,602,488,20899.0,1314,166905,0.003606842215631647,0.0029238189389173483,224
49593,68,73,0.0,162,49661,0.0013692837437828478,0.0014699663720021748,21
84407,586,642,41038.0,1761,84993,0.00689468544468368,0.0075535632346193215,533
13044,190,391,12422.0,825,13234,0.014356959347136164,0.02954511107752758,244
26823,981,359,12430.0,1848,27804,0.03528269313767803,0.01291181125017983,508
34385,163,302,6312.0,918,34548,0.004718073405117517,0.008741461155493806,453
34445,19,122,0.0,251,34464,0.0005512999071494893,0.003539925719591458,110
46164,239,148,14480.0,567,46403,0.00515052906062108,0.003189448958041506,180
39149,77,106,21468.0,226,39226,0.001962983735277622,0.0027022892979146483,43
28819,219,179,1175.0,487,29038,0.007541841724636683,0.006164336386803499,89
22936,176,58,0.0,327,23112,0.00761509172724126,0.0025095188646590515,93
43311,251,288,1071.0,1014,43562,0.0057619025756393185,0.006611266700335155,475
41690,221,358,4637.0,779,41911,0.00527307866669848,0.008541910238362245,200
23269,44,26,0.0,75,23313,0.0018873589842577103,0.0011152575816068288,5
23104,19,38,15889.0,64,23123,0.0008216926869350862,0.0016433853738701725,7
20542,82,67,26868.0,446,20624,0.003975950349107835,0.0032486423584173777,297
99908,122,217,304565.0,995,100030,0.0012196341097670698,0.0021693491952414277,656
35588,426,478,10806.0,1752,36014,0.011828733270394846,0.013272616204809242,848
82182,44,68,16657.0,159,82226,0.0005351105489747769,0.000826989030233746,47
23905,43,49,0.0,169,23948,0.0017955570402538835,0.0020460998830800067,77
16777,56,49,0.0,110,16833,0.003326798550466346,0.0029109487316580527,5
21760,23,58,0.0,156,21783,0.0010558692558417114,0.0026626268190790984,75
23754,23,31,18515.0,483,23777,0.0009673213609790975,0.001303780964797914,429
12290,66,41,15049.0,1827,12356,0.00534153447717708,0.0033182259630948527,1720
12275,76,56,11374.0,1842,12351,0.00615334790705206,0.004534045826248887,1710
10193,102,76,3130.0,1504,10295,0.009907722195240408,0.007382224380767363,1326
11807,132,96,6316.0,1837,11939,0.011056202362006868,0.008040874445095905,1609
7141,100,59,396.0,965,7241,0.013810247203424941,0.008148045850020715,806
30650,31,193,28291.0,364,30681,0.0010103973142987516,0.006290538118053518,140
27618,171,458,39083.0,1277,27789,0.006153513980351938,0.01648134153801864,648
14366,65,125,3315.0,562,14431,0.0045041923636615615,0.00866190839165685,372
35901,149,137,6883.0,852,36050,0.004133148404993065,0.003800277392510402,566
49985,350,300,232090.0,2084,50335,0.006953412138670905,0.005960067547432204,1434
53075,5,52,43394.0,65,53080,9.419743782969103e-05,0.0009796533534287867,8
53377,7,29,1104.0,36,53384,0.00013112543084070133,0.0005432339277686198,0
33005,21,42,0.0,67,33026,0.000635862653666808,0.001271725307333616,4
29135,87,103,24111.0,804,29222,0.002977208952159332,0.0035247416330162207,614
32808,171,135,0.0,375,32979,0.005185117802237788,0.004093514054398254,69
57329,432,1291,6810.0,2537,57761,0.007479094891016429,0.022350721074773636,814
27831,7,19,0.0,26,27838,0.0002514548458941016,0.0006825202959982757,0
17390,55,161,22942.0,468,17445,0.0031527658354829464,0.009229005445686443,252
29329,267,363,0.0,1085,29596,0.00902148939045817,0.012265170969049872,455
17858,62,475,24042.0,811,17920,0.0034598214285714284,0.026506696428571428,274
20297,48,100,75170.0,229,20345,0.002359302039813222,0.004915212582944212,81
140491,230,281,318682.0,888,140721,0.0016344397780004407,0.0019968590331222776,377
69462,14,25,19708.0,77,69476,0.0002015084345673326,0.0003598364902988082,38
29412,147,84,86678.0,1014,29559,0.004973104638181265,0.0028417740789607225,783
61383,343,153,5137.0,1537,61726,0.0055568156044454526,0.0024786961734115285,1041
59232,33,151,0.0,256,59265,0.0005568210579600102,0.0025478781743018646,72
45189,217,402,36243.0,1633,45406,0.004779104083160816,0.008853455490463815,1014
43371,30,123,0.0,170,43401,0.0006912283127116887,0.0028340360821179234,17
41216,446,779,37482.0,1983,41662,0.010705198982286016,0.018698094186548893,758
31426,136,260,2481.0,459,31562,0.004308979152144984,0.008237754261453647,63
29323,3,26,15917.0,35,29326,0.00010229830184818932,0.0008865852826843074,6
23382,166,33,18387.0,258,23548,0.007049430949549856,0.0014013928996093087,59
19759,175,519,9.0,795,19934,0.008778970602989867,0.026035918531152804,101
88789,17,131,96141.0,431,88806,0.00019142850708285476,0.0014751255545796455,283
82676,15,52,0.0,93,82691,0.0001813982174601831,0.0006288471538619681,26
51852,193,804,0.0,1976,52045,0.003708329330387165,0.015448169853011817,979
102305,133,226,89553.0,501,102438,0.0012983463167965013,0.0022062125383158593,142
36225,45,430,0.0,534,36270,0.0012406947890818859,0.011855527984560243,59
25034,73,176,0.0,463,25107,0.0029075556617676346,0.007009997211932927,214
22784,28,70,0.0,159,22812,0.0012274241627213747,0.003068560406803437,61
31497,12,13,0.0,67,31509,0.00038084356850423686,0.0004125805325462566,42
38409,49,133,0.0,321,38458,0.0012741172187841281,0.003458318165271205,139
10527,73,118,0.0,248,10600,0.006886792452830188,0.011132075471698113,57
45996,31,220,0.0,561,46027,0.0006735177178612554,0.004779803159015361,310
223779,542,764,68628.0,2117,224321,0.002416180384359913,0.0034058336045220913,811
62634,96,135,0.0,456,62730,0.0015303682448589192,0.002152080344332855,225
14390,66,224,0.0,808,14456,0.004565578306585501,0.01549529607083564,518
25000,225,152,0.0,1088,25225,0.008919722497522299,0.006025768087215064,711
39250,262,477,15622.0,1742,39512,0.006630896942700952,0.012072281838428832,1003
29464,16,20,3.0,43,29480,0.000542740841248304,0.0006784260515603799,7
11675,39,57,0.0,111,11714,0.003329349496329179,0.0048659723407888,15
335967,504,250,55485.0,1203,336471,0.0014979002648073682,0.0007430060837338137,449
32554,24,56,0.0,144,32578,0.0007366934741236417,0.0017189514396218307,64
381117,568,624,920740.0,1783,381685,0.0014881381243695717,0.001634855967617276,591
63036,537,634,0.0,1279,63573,0.00844698220942853,0.009972787189530147,108
40877,971,479,0.0,1656,41848,0.023203020454979927,0.01144618619766775,206
7952,13,63,7.0,84,7965,0.0016321406151914627,0.007909604519774011,8
12361,36,520,0.0,680,12397,0.002903928369766879,0.04194563200774381,124
43970,437,265,2879.0,1013,44407,0.009840790866304861,0.0059675276420384175,311
36206,157,491,18138.0,931,36363,0.004317575557572257,0.013502736297885213,283
23044,42,278,5476.0,511,23086,0.0018192844147968466,0.012041930174131509,191
48608,274,650,37318.0,1409,48882,0.00560533529724643,0.013297328259891166,485
34160,219,224,23208.0,499,34379,0.006370167835015561,0.00651560545681957,56
22996,65,301,819.0,498,23061,0.002818611508607606,0.013052339447552144,132
20236,702,190,14336.0,1063,20938,0.03352755755086446,0.009074410163339383,171
20554,225,124,0.0,471,20779,0.010828240050050533,0.005967563405361182,122
65161,128,125,31389.0,538,65289,0.001960514022270214,0.0019145644748732558,285
33966,161,104,3.0,416,34127,0.0047176722243385,0.003047440443050957,151
44293,473,130,29.0,857,44766,0.010566054595005137,0.002903989634990841,254
20174,134,157,0.0,410,20308,0.006598384872956471,0.007730943470553476,119
53569,330,324,0.0,824,53899,0.006122562570734151,0.006011243251266257,170
527485,265,287,1772143.0,1291,527750,0.000502131691141639,0.0005438180956892468,739
17799,89,244,0.0,408,17888,0.0049754025044722715,0.013640429338103756,75
15320,181,187,4748.0,446,15501,0.011676666021546997,0.012063737823366234,78
57194,78,230,34410.0,501,57272,0.0013619220561530941,0.004015924011733482,193
59189,58,306,0.0,506,59247,0.0009789525208027412,0.005164818471821358,142
64626,226,113,0.0,751,64852,0.0034848578301363104,0.0017424289150681552,412
64704,170,196,16992.0,736,64874,0.0026204642846132504,0.003021241175201159,370
46224,339,76,14.0,716,46563,0.007280458733329038,0.0016321972381504628,301
45410,424,533,4327.0,1402,45834,0.009250774534188594,0.01162892176113802,445
43988,250,604,5927.0,1205,44238,0.0056512500565125,0.013653420136534202,351
38836,238,274,4393.0,817,39074,0.006091006807595844,0.00701233556840866,305
27687,225,91,13916.0,455,27912,0.008061049011177988,0.0032602464889653197,139
13316,39,40,0.0,170,13355,0.002920254586297267,0.002995132909022838,91
46045,24,138,0.0,393,46069,0.0005209576938939417,0.0029955067398901645,231
102383,63,141,2.0,344,102446,0.0006149581242801085,0.0013763348495792905,140
1775844,583,639,23739135.0,1868,1776427,0.00032818686047892765,0.00035971081277192925,646
29424,60,231,53220.0,373,29484,0.002035002035002035,0.007834757834757835,82
36681,212,399,5803.0,824,36893,0.005746347545604857,0.010815059767435556,213
492681,791,641,3452061.0,1913,493472,0.0016029278256922378,0.0012989592114648855,481
