match,insertion,deletion,soft_clipping,NM,lengths,INS_readLength,DEL_readLength,NM_INS_DEL
123262,174,733,3.0,1496,123436,0.0014096373829352864,0.005938300009721637,589
26928,20,81,2778.0,181,26948,0.0007421701053881549,0.0030057889268220277,80
30780,21,67,0.0,337,30801,0.0006817960455829356,0.0021752540501931757,249
42256,14,79,0.0,220,42270,0.00033120416370948665,0.001868937780932103,127
48755,43,74,0.0,244,48798,0.0008811836550678306,0.0015164555924423132,127
47346,205,323,0.0,1053,47551,0.004311160648566802,0.006792706777985742,525
99648,556,740,42389.0,1850,100204,0.005548680691389566,0.007384934733144386,554
62909,94,273,6571.0,762,63003,0.0014919924448042157,0.004333126993952669,395
18292,59,137,0.0,257,18351,0.0032150836466677563,0.007465533213448858,61
15060,26,53,0.0,105,15086,0.0017234522073445579,0.003513191038048522,26
25207,18,46,0.0,74,25225,0.0007135777998017839,0.001823587710604559,10
38355,12,34,0.0,61,38367,0.0003127687856751896,0.000886178226079704,15
38528,42,204,15630.0,384,38570,0.001088929219600726,0.005289084780917812,138
60152,80,293,0.0,658,60232,0.0013281976358082083,0.004864523841147563,285
59583,31,114,0.0,310,59614,0.0005200120776998691,0.0019123024792833897,165
47432,119,346,27571.0,843,47551,0.002502576181363168,0.007276397972702992,378
139396,525,1786,209139.0,3534,139921,0.0037521172661716252,0.01276434559501433,1223
135146,92,232,67306.0,864,135238,0.0006802821692127952,0.0017154941658409618,540
30302,46,65,1944.0,205,30348,0.0015157506260709108,0.0021418215368393303,94
52064,71,329,49206.0,584,52135,0.0013618490457466194,0.00631053994437518,184
72555,69,204,0.0,516,72624,0.0009500991407799075,0.0028089887640449437,243
43467,74,291,15141.0,624,43541,0.0016995475528811925,0.006683355917411176,259
53343,104,68,0.0,507,53447,0.0019458529010047336,0.0012722884352723259,335
3219615,1319,1663,77419257.0,5104,3220934,0.0004095085462788123,0.000516309865399291,2122
29645,33,437,0.0,529,29678,0.001111934766493699,0.0147247119078105,59
1036639,677,616,5575546.0,1727,1037316,0.0006526458668332505,0.0005938402569708748,434
