match,insertion,deletion,soft_clipping,NM,lengths,INS_readLength,DEL_readLength,NM_INS_DEL
29215,17,304,0.0,351,29232,0.0005815544608648057,0.010399562123700055,30
13111,21,20,11993.0,69,13132,0.0015991471215351812,0.0015229972586049345,28
40090,40,92,0.0,258,40130,0.00099676052828308,0.0022925492150510838,126
26101,58,68,0.0,190,26159,0.002217210138002217,0.0025994877480025997,64
19747,384,352,233.0,846,20131,0.01907505836769162,0.017485470170383984,110
20914,455,261,245.0,784,21369,0.021292526557162246,0.012213954794328232,68
16293,325,363,0.0,753,16618,0.019557106751715007,0.02184378384883861,65
22547,573,375,0.0,1031,23120,0.024783737024221455,0.016219723183391002,83
44489,132,6,152567.0,243,44621,0.0029582483583962707,0.00013446583447255777,105
253189,418,383,443889.0,1088,253607,0.0016482194892096828,0.0015102106803045658,287
197679,352,854,134477.0,1556,198031,0.00177749948240427,0.0043124561306058145,350
25875,511,283,2935.0,863,26386,0.019366330629879483,0.010725384673690594,69
934186,1154,1392,1045685.0,3767,935340,0.0012337759531293434,0.0014882288793379946,1221
14406,34,6,0.0,42,14440,0.0023545706371191134,0.0004155124653739612,2
28583,122,305,0.0,817,28705,0.004250130639261452,0.010625326598153632,390
29843,41,171,0.0,485,29884,0.001371971623611297,0.005722125552134922,273
22807,36,120,0.0,269,22843,0.0015759751346145427,0.005253250448715142,113
13601,19,96,2.0,304,13620,0.001395007342143906,0.007048458149779736,189
24259,53,137,0.0,360,24312,0.002179993418887792,0.0056350773280684436,170
56490,183,275,0.0,1391,56673,0.00322905087078503,0.004852398849540345,933
28565,67,96,4847.0,333,28632,0.002340039117071808,0.003352891869237217,170
16465,27,148,0.0,450,16492,0.001637157409653165,0.008974048023284017,275
32998,41,59,0.0,254,33039,0.001240957656103393,0.0017857683343926874,154
32291,34,139,0.0,289,32325,0.0010518174787316318,0.004300077339520495,116
23267,27,46,0.0,82,23294,0.0011590967631149652,0.001974757448269941,9
12506,39,98,17.0,219,12545,0.0031088082901554403,0.007811877241929055,82
19224,29,160,0.0,319,19253,0.0015062587648678129,0.008310393185477587,130
38593,128,126,15128.0,660,38721,0.0033056997494899406,0.0032540481909041604,406
24331,21,19,0.0,52,24352,0.0008623521681997372,0.0007802233902759526,12
64404,53,61,0.0,223,64457,0.0008222535954202026,0.0009463673456723086,109
622508,337,694,504.0,2201,622845,0.0005410655941686937,0.001114241906092206,1170
35108,73,84,0.0,380,35181,0.002074983655950655,0.0023876524260254117,223
57311,97,195,0.0,453,57408,0.001689659977703456,0.0033967391304347825,161
35202,72,65,0.0,389,35274,0.002041163463174009,0.0018427170153654249,252
27108,235,71,0.0,395,27343,0.008594521449731192,0.0025966426507698496,89
10149,4,63,5317.0,216,10153,0.00039397222495814047,0.006205062543090712,149
2770655,1914,1704,41998348.0,6785,2772569,0.0006903344876178014,0.0006145924591957855,3167
20661,28,20,0.0,78,20689,0.0013533761902460245,0.0009666972787471603,30
37318,66,42,0.0,207,37384,0.0017654611598544832,0.0011234752835437621,99
25222,40,141,0.0,441,25262,0.0015834059061040297,0.005581505819016705,260
27821,17,9,0.0,53,27838,0.0006106760543142467,0.0003232990875781306,27
198654,175,172,84712.0,619,198829,0.0008801532975571974,0.0008650649553133597,272
11547,39,217,0.0,381,11586,0.0033661315380631796,0.018729501122043846,125
192254,218,150,73955.0,531,192472,0.0011326322789808388,0.0007793341369134212,163
18730,24,153,0.0,285,18754,0.0012797269915751307,0.008158259571291458,108
87079,32,80,0.0,186,87111,0.0003673474073308767,0.0009183685183271917,74
22065,27,28,0.0,65,22092,0.0012221618685497012,0.0012674271229404308,10
416352,247,193,272273.0,1330,416599,0.0005928962863569043,0.00046327523589830986,890
207957,127,73,57008.0,583,208084,0.0006103304434747506,0.00035081986120989603,383
152470,410,257,106013.0,2331,152880,0.0026818419675562533,0.0016810570381998954,1664
49010,361,968,0.0,1798,49371,0.0073119847683863,0.019606651678110633,469
30657,25,23,0.0,306,30682,0.0008148099863111922,0.0007496251874062968,258
30282,16,7,0.0,293,30298,0.0005280876625519837,0.00023103835236649284,270
26423,17,8,19.0,256,26440,0.000642965204236006,0.000302571860816944,231
26295,21,324,0.0,564,26316,0.0007979936160510716,0.012311901504787962,219
39317,899,1461,3.0,2791,40216,0.022354286851004577,0.036328824348518,431
28129,8,18,9029.0,282,28137,0.00028432313324092834,0.0006397270497920887,256
26366,12,99,0.0,320,26378,0.0004549245583440746,0.0037531276063386154,209
23399,12,42,0.0,248,23411,0.0005125795566186835,0.0017940284481653924,194
21357,25,230,2964.0,443,21382,0.0011692077448321018,0.010756711252455337,188
40693,371,502,9987.0,1271,41064,0.009034677576466005,0.012224819793493083,398
36079,299,240,0.0,928,36378,0.008219253394909011,0.006597394029358403,389
24194,287,118,0.0,630,24481,0.011723377313018259,0.004820064539847228,225
21620,11,85,0.0,268,21631,0.0005085294253617494,0.003929545559613517,172
23625,334,62,4.0,641,23959,0.013940481656162611,0.0025877540798864727,245
8552,4,207,4074.0,281,8556,0.0004675081813931744,0.024193548387096774,70
44617,13,16,0.0,451,44630,0.000291283889760251,0.0003585032489356935,422
23556,437,324,105.0,983,23993,0.018213645646646938,0.013503938648772558,222
41128,15,111,0.0,494,41143,0.000364582067423377,0.0026979072989329897,368
38134,38,364,0.0,779,38172,0.0009954940794299487,0.009535785392434245,377
31438,23,277,0.0,587,31461,0.0007310638568386256,0.008804551667143447,287
18782,12,13,0.0,193,18794,0.0006385016494625945,0.000691710120251144,168
20501,44,196,0.0,430,20545,0.002141640301776588,0.009540034071550256,190
37097,37,18,0.0,402,37134,0.0009963914471912533,0.0004847309743092584,347
33015,27,29,85.0,357,33042,0.0008171418195024514,0.0008776708431692997,301
24470,33,684,0.0,937,24503,0.0013467738644247643,0.027914949189895115,220
24615,26,70,0.0,303,24641,0.001055151982468244,0.0028407937989529644,207
28088,32,55,0.0,363,28120,0.0011379800853485065,0.0019559032716927453,276
20013,58,488,0.0,727,20071,0.0028897414179662197,0.024313686413233022,181
21077,15,53,0.0,246,21092,0.0007111701118907642,0.002512801062014034,178
24706,46,354,0.0,619,24752,0.0018584356819650936,0.014301874595992243,219
18645,12,11,0.0,195,18657,0.0006431902235086027,0.0005895910382162191,172
21792,21,60,0.0,261,21813,0.0009627286480539128,0.0027506532801540367,180
13530,20,413,138.0,574,13550,0.0014760147601476014,0.03047970479704797,141
17619,74,532,0.0,792,17693,0.004182445034759509,0.03006838862827107,186
20131,14,24,0.0,213,20145,0.0006949615289153636,0.0011913626209977663,175
22026,18,299,5671.0,513,22044,0.0008165487207403375,0.013563781527853385,196
11746,1,81,10843.0,158,11747,8.512811781731506e-05,0.00689537754320252,76
14440,34,81,6250.0,338,14474,0.0023490396573165677,0.005596241536548294,223
34518,30,441,0.0,819,34548,0.0008683570684265369,0.012764848905870093,348
27279,104,657,2581.0,1077,27383,0.003797976846948837,0.023992988350436402,316
26539,27,201,0.0,522,26566,0.0010163366709327712,0.00756606188361063,294
12536,11,141,7553.0,298,12547,0.0008767035944847374,0.011237746074758907,146
51536,914,937,0.0,2503,52450,0.01742612011439466,0.01786463298379409,652
38295,738,1582,0.0,2814,39033,0.018907078625778187,0.04052980811108549,494
36860,694,672,0.0,1783,37554,0.018480055386909517,0.01789423230548011,417
31161,16,320,0.0,628,31177,0.0005131988324726561,0.010263976649453123,292
30061,289,511,0.0,1076,30350,0.009522240527182866,0.016836902800658977,276
25596,231,172,0.0,624,25827,0.00894412823789058,0.006659697216091687,221
12762,11,651,8562.0,774,12773,0.0008611915759805841,0.050966883269396385,112
20236,617,813,0.0,1718,20853,0.029588068862993335,0.03898719608689397,288
23296,375,278,3204.0,949,23671,0.01584216974356808,0.011744328503231802,296
31576,555,412,0.0,1584,32131,0.017273038498646167,0.012822507858454452,617
17702,423,288,3.0,960,18125,0.02333793103448276,0.015889655172413794,249
17112,42,422,11439.0,667,17154,0.002448408534452606,0.02460067622711904,203
17192,105,364,8.0,641,17297,0.006070416835289356,0.02104411169566977,172
13941,32,16,16613.0,412,13973,0.002290130966864668,0.001145065483432334,364
14692,50,757,9132.0,1336,14742,0.003391670058336725,0.051349884683218015,529
10392,354,9,9126.0,552,10746,0.03294249022892239,0.0008375209380234506,189
12363,60,159,2179.0,560,12423,0.004829751267809708,0.012798840859695725,341
11918,18,52,1427.0,266,11936,0.0015080428954423592,0.00435656836461126,196
14359,33,15,18986.0,546,14392,0.002292940522512507,0.0010422456920511395,498
16454,14,20,0.0,139,16468,0.0008501335924216663,0.0012144765606023804,105
391315,51,48,300375.0,635,391366,0.00013031280182744542,0.00012264734289641922,536
47957,60,20,46708.0,115,48017,0.0012495574484036904,0.0004165191494678968,35
960952,533,366,4947489.0,1950,961485,0.0005543508219056979,0.0003806611647607607,1051
37960,37,35,0.0,141,37997,0.0009737610864015581,0.0009211253520014738,69
24356,21,150,0.0,216,24377,0.0008614677770029126,0.006153341264306518,45
29639,45,224,0.0,362,29684,0.0015159681983560166,0.0075461528095943945,93
29982,48,453,14054.0,699,30030,0.0015984015984015984,0.015084915084915084,198
46180,45,236,0.0,357,46225,0.0009734991887506761,0.0051054624121146565,76
1752618,1385,1206,1563689.0,4081,1754003,0.0007896223666664196,0.0006875700896748751,1490
809671,668,548,1881802.0,1850,810339,0.0008243463538099487,0.0006762601824668441,634
265980,263,82,249506.0,428,266243,0.0009878193980686816,0.0003079893180290186,83
19743,24,114,0.0,224,19767,0.0012141447867658219,0.005767187737137654,86
22824,28,141,5.0,345,22852,0.0012252756870295817,0.00617013828111325,176
33655,80,257,0.0,570,33735,0.0023714243367422556,0.007618200681784497,233
17891,56,17,0.0,155,17947,0.003120298657157185,0.0009472335209227169,82
15260,72,123,0.0,286,15332,0.004696060527002348,0.00802243673362901,91
72735,592,285,0.0,1267,73327,0.008073424523026989,0.0038866993058491416,390
24854,138,455,0.0,716,24992,0.005521766965428937,0.01820582586427657,123
20062,74,580,0.0,857,20136,0.003675009932459277,0.028804131903059197,203
20140,22,52,0.0,133,20162,0.001091161591111993,0.0025791092153556196,59
29914,68,46,24214.0,190,29982,0.0022680274831565605,0.0015342538856647323,76
17820,77,91,0.0,240,17897,0.0043023970497848806,0.005084651058836677,72
35188,67,126,775.0,389,35255,0.0019004396539497944,0.0035739611402637924,196
17309,47,83,0.0,218,17356,0.002707997234385803,0.004782207882000461,88
31551,26,129,17.0,239,31577,0.0008233841086867024,0.0040852519238686385,84
15682,28,46,0.0,118,15710,0.0017823042647994907,0.002928071292170592,44
26674,58,439,0.0,619,26732,0.002169684273529852,0.016422265449648362,122
20896,25,216,0.0,443,20921,0.0011949715596768797,0.01032455427560824,202
26219,56,222,0.0,378,26275,0.002131303520456708,0.008449096098953378,100
25885,43,310,0.0,738,25928,0.0016584387534711508,0.011956186362233879,385
19109,231,392,0.0,1095,19340,0.011944157187176835,0.020268872802481904,472
23680,35,86,0.0,171,23715,0.0014758591608686486,0.003626396795277251,50
12331,29,190,0.0,370,12360,0.0023462783171521034,0.015372168284789644,151
33088,73,349,0.0,702,33161,0.0022013811404963664,0.010524411205934682,280
33133,81,173,4681.0,489,33214,0.0024387306557475765,0.005208646956102848,235
549376,717,439,3001341.0,1834,550093,0.001303415967845437,0.0007980468757101072,678
16027,57,16,6557.0,91,16084,0.0035438945535936333,0.000994777418552599,18
29785,25,58,0.0,197,29810,0.0008386447500838644,0.0019456558201945656,114
18898,34,67,0.0,171,18932,0.0017959011197971689,0.0035389816184238326,70
24932,114,99,0.0,377,25046,0.004551625009981634,0.003952726982352471,164
11876,55,55,0.0,167,11931,0.004609839912832118,0.004609839912832118,57
18347,65,144,0.0,392,18412,0.0035303063219639364,0.007820986313273952,183
33248,150,146,2866.0,790,33398,0.004491286903407389,0.004371519252649859,494
29727,87,230,0.0,509,29814,0.002918092171463071,0.007714496545247199,192
32988,65,185,2.0,964,33053,0.0019665385895380146,0.00559707137022358,714
20887,35,88,0.0,195,20922,0.0016728802217761208,0.004206098843322818,72
20059,65,189,0.0,496,20124,0.003229974160206718,0.009391771019677997,242
29310,108,468,0.0,1252,29418,0.003671221700999388,0.01590862737099735,676
25524,56,64,0.0,240,25580,0.00218921032056294,0.002501954652071931,120
33589,56,131,0.0,461,33645,0.0016644375092881556,0.0038935948877990784,274
22777,19,56,9201.0,90,22796,0.0008334795578171609,0.0024565713283032113,15
37127,29,27,0.0,61,37156,0.0007804930563031542,0.0007266659489719023,5
29348,55,319,0.0,590,29403,0.0018705574261129816,0.010849233071455293,216
19340,25,275,0.0,479,19365,0.0012909888974954814,0.014200877872450297,179
19284,36,134,0.0,184,19320,0.0018633540372670807,0.006935817805383023,14
20237,29,265,236.0,614,20266,0.0014309681239514458,0.013076088029211487,320
39696,42,75,0.0,150,39738,0.0010569228446323418,0.0018873622225577533,33
37216,156,268,3734.0,873,37372,0.004174248100181954,0.00717114417210746,449
3947072,2185,1248,14019347.0,6188,3949257,0.0005532686274911965,0.0003160088087455438,2755
11891,15,145,3714.0,229,11906,0.0012598689736267427,0.01217873341172518,69
35139,11,82,3.0,121,35150,0.00031294452347083927,0.002332859174964438,28
742763,11038,10485,990949.0,27392,753801,0.014643121991082527,0.013909506620447572,5869
30167,26,16,0.0,53,30193,0.0008611267512337297,0.0005299241546053721,11
2035057,1290,810,2889672.0,4042,2036347,0.0006334873182222872,0.0003977711067907385,1942
13800,26,4,14981.0,35,13826,0.0018805149717922754,0.0002893099956603501,5
4508223,19103,18460,18490539.0,48164,4527326,0.0042194885016011655,0.004077462060386197,10601
18133,23,27,2437.0,104,18156,0.00126679885437321,0.001487111698612029,54
29685,18,76,700.0,171,29703,0.000605999394000606,0.0025586641080025587,77
2354349,1598,1562,10429718.0,5663,2355947,0.0006782835097733523,0.0006630030302039901,2503
719286,285,328,2059757.0,1278,719571,0.00039606932463926423,0.00045582715256729355,665
