match,insertion,deletion,soft_clipping,NM,lengths,INS_readLength,DEL_readLength,NM_INS_DEL
221659,109,111,583678.0,401,221768,0.0004915046354749107,0.0005005230691533494,181
439688,480,267,584264.0,1307,440168,0.0010904927209610877,0.000606586576034605,560
2185753,962,821,16318159.0,3597,2186715,0.0004399293003432089,0.00037544901827627283,1814
13789,12,67,10929.0,152,13801,0.0008695022099847838,0.004854720672415043,73
18962,138,72,0.0,307,19100,0.007225130890052356,0.003769633507853403,97
833080,1636,738,957683.0,3028,834716,0.0019599480541884905,0.0008841330464493313,654
11015,17,65,2753.0,110,11032,0.0015409717186366933,0.005891950688905003,28
864043,2149,1459,2840154.0,5234,866192,0.002480974195097623,0.0016843840626558546,1626
25069,339,470,19327.0,1705,25408,0.013342254408060453,0.018498110831234257,896
32718,257,503,8539.0,1313,32975,0.007793783169067476,0.015253980288097043,553
14103,28,100,2.0,198,14131,0.001981459203170335,0.007076640011322624,70
20949,22,20,0.0,92,20971,0.001049067760240332,0.0009536979638548472,50
36435,495,179,52420.0,1963,36930,0.013403736799350122,0.004847007852694286,1289
24486,36,324,0.0,656,24522,0.0014680694886224615,0.013212625397602153,296
14817,21,36,0.0,115,14838,0.0014152850788515972,0.002426202992317024,58
24227,32,49,0.0,126,24259,0.001319098066696896,0.002019868914629622,45
23179,27,100,0.0,267,23206,0.0011634922002930277,0.004309230371455658,140
29306,68,45,0.0,279,29374,0.0023149724245931777,0.0015319670456866617,166
23517,135,340,0.0,684,23652,0.005707762557077625,0.014375105699306612,209
63898,96,220,0.0,525,63994,0.00150014063818483,0.0034378222958402352,209
40875,40,238,0.0,477,40915,0.0009776365636074789,0.005816937553464499,199
35056,111,276,0.0,552,35167,0.003156368186083544,0.007848266841072597,165
32325,74,90,0.0,292,32399,0.0022840211117627087,0.0027778635143059973,128
61088,43,205,0.0,380,61131,0.0007034074364888518,0.00335345405767941,132
54729,92,51,0.0,237,54821,0.0016781890151584247,0.0009303004323160832,94
193762,143,80,63985.0,495,193905,0.0007374745364998324,0.0004125731672726335,272
44687,185,399,1210.0,1923,44872,0.004122838295596363,0.008891959351042967,1339
33130,399,447,4223.0,1483,33529,0.011900146142145605,0.013331742670524024,637
33157,82,119,0.0,728,33239,0.0024669815578085984,0.0035801317729173563,527
37452,295,276,231.0,1603,37747,0.007815190611174397,0.0073118393514716405,1032
28041,30,193,0.0,692,28071,0.0010687186063909372,0.006875423034448363,469
29292,48,210,0.0,698,29340,0.0016359918200408998,0.007157464212678937,440
29606,22,69,0.0,569,29628,0.0007425408397461861,0.002328878088294856,478
25920,754,1023,0.0,3098,26674,0.028267226512709007,0.03835195321286646,1321
28708,19,88,0.0,546,28727,0.000661398684164723,0.003063320221394507,439
13879,15,426,0.0,726,13894,0.001079602706204117,0.03066071685619692,285
22571,98,483,0.0,989,22669,0.004323084388371785,0.02130663019983237,408
32424,74,71,234.0,1494,32498,0.00227706320388947,0.002184749830758816,1349
19130,395,42,0.0,721,19525,0.020230473751600513,0.002151088348271447,284
20799,89,269,12.0,1254,20888,0.004260819609345079,0.012878207583301417,896
30693,49,244,0.0,1750,30742,0.0015939106108906382,0.007937024266475832,1457
23956,376,251,7.0,1227,24332,0.015452901528850895,0.010315633733355253,600
19029,71,85,4507.0,1677,19100,0.0037172774869109948,0.004450261780104712,1521
24918,46,227,0.0,912,24964,0.0018426534209261337,0.009093094055439833,639
18198,24,367,8.0,743,18222,0.0013170892327955218,0.020140489518164856,352
21921,53,56,0.0,370,21974,0.002411941385273505,0.0025484663693455902,261
21679,47,54,0.0,955,21726,0.002163306637208874,0.0024855012427506215,854
22548,31,307,48.0,1146,22579,0.0013729571725940033,0.013596704902785774,808
20077,30,443,0.0,796,20107,0.0014920177052767693,0.02203212811458696,323
18117,37,118,3731.0,569,18154,0.0020381183210311776,0.006499944915721053,414
17785,39,47,0.0,675,17824,0.0021880610412926393,0.00263689407540395,589
16487,8,65,2584.0,280,16495,0.0004849954531676266,0.003940588056986966,207
14822,241,54,0.0,450,15063,0.015999468897298016,0.0035849432383987254,155
13493,22,136,0.0,317,13515,0.0016278209396966333,0.010062893081761006,159
12912,7,65,0.0,208,12919,0.000541837603529685,0.005031349175632789,136
13279,24,35,8762.0,477,13303,0.001804104337367511,0.002630985491994287,418
20333,172,197,2.0,1295,20505,0.008388198000487686,0.009607412826139966,926
13143,43,159,2.0,584,13186,0.003261034430456545,0.012058243591688155,382
16682,395,802,20.0,1348,17077,0.023130526439070095,0.04696375241552966,151
18068,46,43,1215.0,246,18114,0.0025394722314232084,0.0023738544771999557,157
22117,582,782,142.0,1485,22699,0.025639896030662145,0.03445085686594123,121
19701,201,136,0.0,462,19902,0.010099487488694603,0.006833484071952568,125
34448,1129,1500,3029.0,2911,35577,0.03173398544003148,0.042162071000927566,282
49744,963,1031,5.0,3086,50707,0.018991460745064782,0.020332498471611414,1092
19991,34,25,32.0,209,20025,0.0016978776529338326,0.0012484394506866417,150
29621,78,95,1964.0,812,29699,0.0026263510555910976,0.003198760901040439,639
26781,904,733,0.0,1891,27685,0.0326530612244898,0.026476431280476793,254
25888,51,153,275.0,624,25939,0.0019661513551023557,0.005898454065307066,420
25507,53,123,180.0,896,25560,0.002073552425665102,0.004812206572769953,720
23726,54,70,39.0,603,23780,0.0022708158116063917,0.002943650126156434,479
22347,26,29,23.0,376,22373,0.0011621150493898896,0.0012962052473964153,321
21228,20,40,139.0,333,21248,0.0009412650602409639,0.0018825301204819277,273
25939,81,93,35.0,957,26020,0.003112990007686395,0.003574173712528824,783
23606,52,89,0.0,512,23658,0.002197987995604024,0.003761940992476118,371
13752,24,85,0.0,173,13776,0.0017421602787456446,0.006170150987224158,64
48445,800,648,0.0,3796,49245,0.01624530409178597,0.013158696314346635,2348
19217,25,35,93.0,405,19242,0.0012992412431140213,0.00181893774035963,345
16517,24,128,30.0,251,16541,0.001450940088265522,0.007738347137416117,99
24509,51,51,0.0,738,24560,0.002076547231270358,0.002076547231270358,636
16366,376,255,0.0,1265,16742,0.022458487635885795,0.01523115517859276,634
17064,16,128,152.0,350,17080,0.000936768149882904,0.007494145199063232,206
22580,404,524,0.0,1074,22984,0.017577445179255136,0.022798468499825964,146
16703,25,121,0.0,309,16728,0.0014945002391200382,0.007233381157340985,163
33984,93,97,3.0,1657,34077,0.002729113478299146,0.0028464947031722277,1467
31486,360,608,1839.0,1419,31846,0.011304402436726747,0.019091879670916283,451
27149,467,445,0.0,1253,27616,0.016910486674391656,0.016113847045191195,341
12086,53,69,0.0,333,12139,0.004366092758876349,0.005684158497405058,211
18392,276,554,0.0,1093,18668,0.014784658238697236,0.029676451682022712,263
13096,89,175,6.0,453,13185,0.006750094804702313,0.013272658323852863,189
18427,35,85,0.0,333,18462,0.0018957859386848663,0.004604051565377533,213
19912,23,43,0.0,175,19935,0.0011537496864810635,0.0021570102834211186,109
18173,724,800,259.0,1869,18897,0.03831295972905752,0.04233476213155527,345
24977,73,116,0.0,1248,25050,0.0029141716566866266,0.004630738522954092,1059
16262,31,168,0.0,312,16293,0.001902657583011109,0.010311176578898913,113
27376,5,24,0.0,161,27381,0.00018260837807238596,0.0008765202147474527,132
22905,18,626,2.0,838,22923,0.0007852375343541421,0.027308816472538498,194
24528,22,15,0.0,149,24550,0.0008961303462321792,0.0006109979633401223,112
23388,13,29,0.0,178,23401,0.000555531814879706,0.0012392632793470364,136
21874,18,18,5.0,140,21892,0.0008222181618856204,0.0008222181618856204,104
20905,7,33,0.0,138,20912,0.0003347360367253252,0.0015780413159908187,98
15264,272,79,0.0,426,15536,0.017507723995880537,0.005084963954685891,75
23358,14,20,0.0,138,23372,0.0005990073592332706,0.0008557247989046722,104
20994,10,20,0.0,123,21004,0.00047609979051609216,0.0009521995810321843,93
23828,47,157,0.0,413,23875,0.001968586387434555,0.006575916230366492,209
20247,13,113,101.0,221,20260,0.0006416584402764067,0.005577492596248766,95
18176,14,46,0.0,143,18190,0.0007696536558548653,0.0025288620120945573,83
16581,33,133,0.0,244,16614,0.0019862766341639583,0.008005296737691105,78
15242,34,69,24.0,167,15276,0.0022257135375752814,0.004516889238020424,64
13824,27,111,0.0,202,13851,0.001949317738791423,0.008013861815031406,64
12715,14,24,0.0,82,12729,0.0010998507345431692,0.0018854584020740043,44
11908,21,60,0.0,164,11929,0.0017604157934445468,0.0050297594098415626,83
15727,210,427,0.0,960,15937,0.013176883980673904,0.02679299742737027,323
37501,1651,2266,0.0,5045,39152,0.0421689824274622,0.05787699223539027,1128
21027,221,133,10.0,747,21248,0.01040097891566265,0.006259412650602409,393
25324,38,64,18.0,766,25362,0.0014983045501143443,0.002523460294929422,664
26189,119,121,0.0,1029,26308,0.004523338908316862,0.004599361410977649,789
14014,27,81,604.0,354,14041,0.0019229399615412009,0.005768819884623602,246
14758,49,233,474.0,772,14807,0.0033092456270682785,0.015735800634834877,490
16953,25,294,0.0,700,16978,0.0014724938155259747,0.017316527270585462,381
13912,9,28,0.0,92,13921,0.0006465052797931183,0.002011349759356368,55
23712,97,177,0.0,1075,23809,0.00407408962997186,0.007434163551598135,801
28886,50,93,0.0,1148,28936,0.0017279513408902404,0.0032139894940558474,1005
38610,1023,771,0.0,2529,39633,0.025811823480432972,0.019453485731587315,735
50436,1483,1864,0.0,4839,51919,0.028563724262793966,0.035902078237254186,1492
31057,62,117,19.0,1112,31119,0.00199235193932967,0.0037597609177672806,933
18290,361,394,4004.0,1285,18651,0.019355530534555788,0.021124872660983326,530
28643,307,504,155.0,1431,28950,0.010604490500863558,0.017409326424870468,620
31355,882,696,309.0,1922,32237,0.0273598659924931,0.02159009833421224,344
17423,17,75,0.0,172,17440,0.0009747706422018349,0.0043004587155963305,80
12466,38,62,0.0,148,12504,0.0030390275111964174,0.004958413307741522,48
13485,36,67,0.0,162,13521,0.002662524961171511,0.004955254788846979,59
22792,308,288,0.0,1255,23100,0.013333333333333334,0.012467532467532468,659
25983,793,603,0.0,1871,26776,0.029616074096205557,0.02252016731401255,475
20470,64,64,19629.0,1084,20534,0.0031167819226648485,0.0031167819226648485,956
24552,83,105,0.0,1060,24635,0.0033691901765780393,0.004262228536634869,872
22839,454,507,18295.0,1763,23293,0.019490834156184262,0.02176619585283132,802
19260,82,57,138.0,670,19342,0.00423947885430669,0.0029469548133595285,531
16146,43,63,0.0,268,16189,0.0026561245290011738,0.0038915312866761383,162
14281,59,163,0.0,588,14340,0.004114365411436541,0.011366806136680613,366
12889,112,23,0.0,207,13001,0.00861472194446581,0.0017690946850242289,72
17709,15,99,196.0,212,17724,0.0008463100880162492,0.005585646580907245,98
14001,46,45,0.0,322,14047,0.0032747205809069554,0.003203531003061152,231
14438,71,62,0.0,366,14509,0.004893514370390792,0.004273209731890551,233
16087,267,209,0.0,951,16354,0.016326281032163385,0.012779748073865721,475
27684,76,204,981.0,1472,27760,0.002737752161383285,0.007348703170028818,1192
18767,45,44,0.0,224,18812,0.0023920901552200724,0.002338932596215182,135
25624,75,102,0.0,1063,25699,0.002918401494221565,0.003969026032141328,886
14488,41,123,0.0,248,14529,0.0028219423222520476,0.008465826966756143,84
14084,26,21,0.0,130,14110,0.001842664776754075,0.00148830616583983,83
25805,212,54,0.0,764,26017,0.008148518276511512,0.002075565976092555,498
28068,542,376,242.0,1462,28610,0.01894442502621461,0.013142257951765117,544
52337,2224,2920,35.0,6714,54561,0.04076171624420374,0.05351808068033943,1570
43531,30,109,583.0,876,43561,0.0006886894240260784,0.0025022382406280847,737
19484,8,16,0.0,108,19492,0.0004104247896572953,0.0008208495793145906,84
39153,103,119,72.0,2010,39256,0.002623802730792745,0.003031383737517832,1788
18084,33,92,3.0,210,18117,0.0018214936247723133,0.005078103438759176,85
12245,17,119,0.0,202,12262,0.0013863969988582613,0.009704778992007829,66
19802,31,88,0.0,225,19833,0.0015630514798568042,0.004437049362174155,106
21349,41,56,0.0,240,21390,0.001916783543712015,0.0026180458158017767,143
18685,51,96,0.0,228,18736,0.0027220324508966695,0.005123825789923143,81
21338,23,78,2825.0,208,21361,0.0010767286175740836,0.003651514442207762,107
18494,19,124,22.0,247,18513,0.0010263058391400638,0.006697996002808837,104
18992,17,15,0.0,116,19009,0.0008943132200536588,0.000789099900047346,84
19701,25,72,0.0,195,19726,0.0012673628713373213,0.0036500050694514854,98
19502,8,4,8.0,98,19510,0.00041004613018964635,0.00020502306509482317,86
11511,15,47,0.0,109,11526,0.0013014055179593961,0.004077737289606108,47
34222,14,32,2.0,235,34236,0.0004089262764341629,0.0009346886318495151,189
17289,4,9,0.0,85,17293,0.00023130746544844735,0.0005204417972590065,72
15607,44,103,0.0,218,15651,0.0028113219602581303,0.006581049134240623,71
16217,337,780,0.0,1229,16554,0.020357617494261206,0.04711852120333454,112
19289,4,2,0.0,93,19293,0.00020732908308713005,0.00010366454154356503,87
19852,43,137,2.0,289,19895,0.0021613470721286755,0.006886152299572757,109
20743,18,16,0.0,129,20761,0.0008670102596214055,0.0007706757863301382,95
13923,57,24,60.0,146,13980,0.00407725321888412,0.0017167381974248926,65
20503,22,38,0.0,183,20525,0.001071863580998782,0.001851400730816078,123
30194,191,672,0.0,1067,30385,0.006285996379792661,0.022116175744610826,204
34556,14,15,0.0,241,34570,0.000404975412207116,0.00043390222736476716,212
12518,31,56,0.0,149,12549,0.0024703163598693125,0.0044625069726671445,62
13826,18,13,0.0,89,13844,0.0013002022536839064,0.0009390349609939324,58
11146,16,69,0.0,130,11162,0.0014334348683031715,0.006181687869557427,45
20434,631,645,11194.0,2232,21065,0.02995490149537147,0.030619511037265606,956
20785,105,89,0.0,989,20890,0.005026328386787937,0.004260411680229775,795
18978,35,41,52.0,318,19013,0.0018408457371272286,0.002156419292063325,242
23364,56,100,0.0,540,23420,0.0023911187019641333,0.004269854824935952,384
24113,27,28,170.0,312,24140,0.0011184755592377796,0.00115990057995029,257
14827,48,127,0.0,253,14875,0.003226890756302521,0.00853781512605042,78
28495,46,51,105.0,933,28541,0.0016117164780491222,0.0017869030517501138,836
20640,71,106,27.0,869,20711,0.003428129979238086,0.00511805320843996,692
17415,37,88,3016.0,217,17452,0.002120100848040339,0.0050424020169608065,92
21226,17,20,0.0,143,21243,0.0008002636162500589,0.0009414866073530104,106
25005,158,235,0.0,1553,25163,0.006279060525374558,0.009339109009259628,1160
18645,62,137,14.0,773,18707,0.003314267386539798,0.007323461805741166,574
68666,2740,3424,0.0,8544,71406,0.03837212559168697,0.04795115256421029,2380
24197,315,546,0.0,1767,24512,0.012850848563968668,0.022274804177545692,906
32886,364,315,513.0,1795,33250,0.010947368421052631,0.009473684210526316,1116
22572,22,122,1164.0,629,22594,0.0009737098344693282,0.005399663627511729,485
14414,8,78,106.0,256,14422,0.000554708084870337,0.005408403827485786,170
17826,200,117,176.0,749,18026,0.011095084877399313,0.006490624653278597,432
28028,738,1021,88.0,2792,28766,0.025655287492178266,0.03549329069039839,1033
18399,31,162,1383.0,665,18430,0.0016820401519262072,0.008790016277807922,472
20813,59,98,138.0,909,20872,0.002826753545419701,0.004695285550019164,752
18808,37,150,0.0,627,18845,0.0019633855133987794,0.007959671000265322,440
26132,56,70,0.0,777,26188,0.0021383839926683978,0.0026729799908354972,651
16254,38,90,82.0,459,16292,0.002332433095998036,0.005524183648416401,331
47184,1184,1101,39.0,4452,48368,0.02447899437644724,0.022762983790936157,2167
26047,358,469,2450.0,1400,26405,0.013558038250331377,0.01776178754023859,573
22873,592,926,2830.0,3081,23465,0.02522906456424462,0.039463030044747494,1563
28676,1047,550,0.0,2046,29723,0.03522524644214918,0.01850418867543653,449
16883,1028,27,0.0,1436,17911,0.05739489699067612,0.0015074535201831277,381
20402,389,205,5353.0,991,20791,0.01871001875811649,0.009860035592323601,397
32233,710,654,1506.0,2068,32943,0.02155237835048417,0.01985247245241781,704
27129,380,354,108907.0,1375,27509,0.01381366098367807,0.012868515758479044,641
22006,333,540,29262.0,1385,22339,0.014906665472939703,0.024172971037199516,512
13533,416,71,8046.0,1092,13949,0.02982292637465051,0.0050899706072119865,605
36386,279,89,0.0,703,36665,0.007609436792581481,0.002427383062866494,335
35017,382,261,0.0,2130,35399,0.010791265289979942,0.007373089635300432,1487
25206,136,134,32.0,770,25342,0.005366585115618341,0.005287664746271013,500
36125,194,151,0.0,1067,36319,0.005341556760924035,0.004157603458244996,722
23042,42,81,0.0,279,23084,0.0018194420377750822,0.0035089239299948014,156
13145,64,57,0.0,410,13209,0.004845181315769551,0.004315239609357257,289
26115,34,73,0.0,218,26149,0.001300240926995296,0.0027916937550193123,111
17982,39,48,19679.0,559,18021,0.002164141834526386,0.002663559180955552,472
19443,22,22,4843.0,150,19465,0.0011302337528898022,0.0011302337528898022,106
15710,77,43,0.0,426,15787,0.004877430797491607,0.0027237600557420663,306
11824,21,29,26279.0,418,11845,0.0017728999577880963,0.002448290417897847,368
10954,30,128,0.0,361,10984,0.0027312454479242534,0.011653313911143482,203
22142,10,3,10241.0,81,22152,0.0004514265077645359,0.00013542795232936077,68
12599,286,37,8191.0,1026,12885,0.022196352347691115,0.0028715560729530463,703
10401,279,36,5920.0,863,10680,0.026123595505617977,0.0033707865168539327,548
78091,1056,453,14930.0,1931,79147,0.013342261867158579,0.005723527107786777,422
16074,351,397,608.0,2181,16425,0.021369863013698632,0.02417047184170472,1433
14028,319,312,13680.0,1761,14347,0.022234613508050463,0.021746706628563463,1130
38128,862,1404,2647.0,4822,38990,0.0221082328802257,0.03600923313670172,2556
18366,222,488,15842.0,2361,18588,0.011943189154293092,0.02625349687970734,1651
15876,278,768,19311.0,1831,16154,0.01720935991085799,0.047542404358053736,785
9166,54,37,24164.0,1240,9220,0.005856832971800434,0.004013015184381779,1149
8495,42,369,8821.0,1294,8537,0.004919761040178048,0.04322361485299286,883
7517,44,60,15139.0,942,7561,0.00581933606665785,0.007935458272715249,838
6139,21,18,39027.0,73,6160,0.003409090909090909,0.002922077922077922,34
20574,108,29,5330.0,1065,20682,0.005221932114882507,0.001402185475292525,928
29179,19,15,19862.0,272,29198,0.0006507295020206864,0.0005137338173847524,238
13794,102,206,7778.0,765,13896,0.007340241796200345,0.014824409902130109,457
27479,359,429,0.0,974,27838,0.01289604138228321,0.015410589841224226,186
69197,69,59,11362.0,470,69266,0.0009961597320474692,0.0008517887563884157,342
34348,484,409,684.0,2223,34832,0.013895268718419843,0.011742076251722553,1330
16329,52,72,1638.0,542,16381,0.003174409376716928,0.004395336060069593,418
23384,111,63,17777.0,851,23495,0.004724409448818898,0.0026814215790593745,677
34670,78,83,4760.0,452,34748,0.002244733509842293,0.0023886266835501323,291
30472,100,195,5.0,1179,30572,0.003270966897814994,0.006378385450739239,884
33609,41,118,0.0,367,33650,0.0012184249628528975,0.0035066864784546806,208
21678,82,193,2.0,556,21760,0.0037683823529411765,0.008869485294117647,281
27081,111,206,12738.0,797,27192,0.004082082965578111,0.007575757575757576,480
24096,155,237,5393.0,875,24251,0.006391489010762443,0.009772792874520639,483
17138,29,345,0.0,648,17167,0.001689287586648803,0.020096697151511623,274
19622,23,31,8512.0,268,19645,0.0011707813693051666,0.0015780096716721812,214
14541,81,74,7692.0,634,14622,0.00553959786622897,0.005060867186431404,479
37242,1017,841,7081.0,7487,38259,0.026581980710421078,0.021981755926710055,5629
31483,1033,852,11554.0,6760,32516,0.031768975273711406,0.026202484930495755,4875
19912,619,513,3121.0,3930,20531,0.030149529979056063,0.024986605620768595,2798
66775,2,3,100455.0,104,66777,2.9950432034982106e-05,4.4925648052473156e-05,99
13146,51,42,71962.0,818,13197,0.003864514662423278,0.003182541486701523,725
37105,27,222,24791.0,552,37132,0.0007271356242593989,0.005978670688355058,303
83263,238,51,2905.0,403,83501,0.0028502652662842362,0.0006107711284894791,114
20095,107,102,0.0,259,20202,0.005296505296505297,0.005049005049005049,50
31409,31,237,9241.0,555,31440,0.000986005089058524,0.007538167938931297,287
40221,15,19,42837.0,58,40236,0.0003728004771846108,0.0004722139377671737,24
20243,13,169,6277.0,333,20256,0.0006417851500789889,0.008343206951026857,151
31083,24,48,0.0,163,31107,0.0007715305236763429,0.0015430610473526859,91
13426,42,44,0.0,98,13468,0.0031185031185031187,0.003267003267003267,12
19481,37,74,0.0,178,19518,0.001895686033405062,0.003791372066810124,67
20069,194,102,0.0,945,20263,0.009574100577407096,0.00503380545822435,649
31595,181,125,4488.0,1287,31776,0.005696122860020141,0.003933786505538771,981
20086,79,102,0.0,739,20165,0.003917679147036945,0.005058269278452765,558
27455,107,468,5821.0,1602,27562,0.00388215659240984,0.016979899862129017,1027
24803,119,411,1630.0,1156,24922,0.0047748976807639835,0.016491453334403338,626
26609,10,40,14765.0,63,26619,0.00037567151282918217,0.0015026860513167287,13
19134,18,21,0.0,58,19152,0.0009398496240601503,0.0010964912280701754,19
38613,147,106,0.0,407,38760,0.0037925696594427244,0.0027347781217750256,154
49440,354,172,2461.0,1573,49794,0.00710929027593686,0.0034542314335060447,1047
32481,83,78,0.0,494,32564,0.002548826925439135,0.002395283134750031,333
20326,36,42,3.0,171,20362,0.0017679992142225715,0.0020626657499263333,93
41729,70,329,0.0,494,41799,0.0016746812124691977,0.00787100169860523,95
31840,116,334,32550.0,851,31956,0.0036299912379521844,0.01045187132306922,401
21758,40,71,0.0,222,21798,0.0018350307367648408,0.0032571795577575925,111
18977,34,405,2.0,815,19011,0.0017884382725790332,0.02130345589395613,376
103268,281,383,33378.0,998,103549,0.002713691102762943,0.0036987320012747587,334
9921,63,120,6877.0,612,9984,0.006310096153846154,0.01201923076923077,429
12593,290,186,4610.0,1067,12883,0.022510284871536133,0.014437630986571451,591
9964,292,143,7445.0,910,10256,0.02847113884555382,0.013943057722308892,475
35873,17,58,0.0,133,35890,0.00047366954583449427,0.0016160490387294511,58
15815,25,37,0.0,69,15840,0.0015782828282828283,0.0023358585858585857,7
24470,36,400,3.0,878,24506,0.001469027993144536,0.01632253325716151,442
26121,136,108,26790.0,1778,26257,0.005179571161975854,0.004113188863922002,1534
22701,24,194,0.0,590,22725,0.001056105610561056,0.008536853685368537,372
20224,26,42,0.0,79,20250,0.0012839506172839506,0.002074074074074074,11
13346,79,211,293.0,841,13425,0.005884543761638734,0.015716945996275607,551
23994,7,82,0.0,104,24001,0.0002916545143952335,0.0034165243114870213,15
78472,1938,1826,0.0,8273,80410,0.024101479915433405,0.02270861833105335,4509
24995,661,542,32.0,2311,25656,0.025763953850951045,0.021125662613033988,1108
68274,2782,3273,15936.0,8207,71056,0.039152217968925915,0.04606226075208286,2152
45179,1247,1469,0.0,4240,46426,0.026859949166415372,0.03164175246629044,1524
19658,15,100,7.0,393,19673,0.0007624663244040054,0.005083108829360037,278
33150,190,269,42375.0,536,33340,0.005698860227954409,0.008068386322735453,77
27436,34,166,0.0,378,27470,0.0012377138696760101,0.006042955951947579,178
14942,61,72,8527.0,631,15003,0.004065853495967473,0.004799040191961607,498
47278,102,259,0.0,971,47380,0.002152807091599831,0.005466441536513297,610
34481,80,440,5488.0,1025,34561,0.00231474783715749,0.012731113104366193,505
29888,18,72,0.0,211,29906,0.0006018859091821039,0.0024075436367284155,121
32198,39,138,0.0,367,32237,0.0012097899928653411,0.004280795359369668,190
40077,96,80,290.0,567,40173,0.002389664700171757,0.001991387250143131,391
21703,37,64,0.0,173,21740,0.0017019319227230911,0.0029438822447102114,72
15365,12,115,0.0,317,15377,0.000780386291214151,0.007478701957468947,190
41108,69,91,0.0,288,41177,0.0016756927410933287,0.0022099715860796074,128
27942,88,131,2.0,500,28030,0.003139493399928648,0.004673564038530146,281
15948,32,150,0.0,366,15980,0.002002503128911139,0.009386733416770964,184
39209,41,38,9625.0,216,39250,0.0010445859872611465,0.0009681528662420382,137
10575,221,136,4877.0,787,10796,0.020470544646165247,0.012597258243793997,430
37205,379,268,0.0,2056,37584,0.010084078331204768,0.007130693912303108,1409
20403,120,536,844.0,968,20523,0.0058470983774302,0.026117039419188227,312
22715,32,34,0.0,143,22747,0.0014067789159009979,0.0014947025981448103,77
23911,337,148,11356.0,1368,24248,0.013898053447707028,0.006103596172880237,883
11316,39,91,0.0,290,11355,0.0034346103038309117,0.008014090708938793,160
20442,120,118,2.0,935,20562,0.005836008170411439,0.005738741367571248,697
19802,78,111,2.0,549,19880,0.003923541247484909,0.005583501006036217,360
27292,139,53,0.0,287,27431,0.005067259669716744,0.0019321205934891182,95
12261,147,104,4.0,690,12408,0.011847195357833656,0.008381689232753063,439
20612,138,37,576.0,238,20750,0.006650602409638554,0.001783132530120482,63
46705,45,27,17858.0,123,46750,0.0009625668449197861,0.0005775401069518717,51
15698,111,184,0.0,409,15809,0.007021316971345436,0.011638939844392435,114
60106,18,47,0.0,136,60124,0.00029938127869070586,0.0007817177832479543,71
45580,16,52,14393.0,166,45596,0.0003509079743837179,0.001140450916747083,98
20350,62,238,4721.0,921,20412,0.0030374289633548894,0.011659807956104253,621
20807,74,122,2066.0,1132,20881,0.003543891576073943,0.005842632057851635,936
14619,10,9,12126.0,27,14629,0.0006835737234260715,0.0006152163510834643,8
17715,27,70,0.0,169,17742,0.0015218126479540075,0.0039454401983992785,72
25641,37,84,0.0,222,25678,0.001440922190201729,0.0032712828101877094,101
16723,72,68,0.0,185,16795,0.004286990175647514,0.0040488240547782075,45
25723,55,357,0.0,827,25778,0.0021336022965319263,0.013849018542943596,415
19904,104,53,0.0,186,20008,0.005197920831667333,0.002648940423830468,29
22299,253,597,0.0,1537,22552,0.011218517204682511,0.026472153245831857,687
46612,90,113,2.0,350,46702,0.0019271123292364353,0.002419596591152413,147
22031,23,268,2376.0,475,22054,0.0010428947129772377,0.012151990568604335,184
31293,17,75,2.0,176,31310,0.0005429575215586074,0.0023954008304056212,84
23088,30,125,2.0,713,23118,0.0012976901116013497,0.00540704213167229,558
22551,18,57,0.0,206,22569,0.0007975541672205237,0.002525588196198325,131
25087,214,187,1710.0,831,25301,0.00845816370894431,0.007391012212956009,430
16726,18,104,6265.0,533,16744,0.001075011944577162,0.006211180124223602,411
44020,83,124,0.0,375,44103,0.0018819581434369544,0.0028116001179058115,168
42464,247,453,78695.0,2770,42711,0.005783053545924937,0.010606167029570837,2070
26758,54,59,0.0,251,26812,0.0020140235715351337,0.002200507235566164,138
20273,106,422,0.0,1630,20379,0.005201432847539133,0.020707591147750136,1102
25293,12,49,0.0,101,25305,0.0004742145820983995,0.0019363762102351315,40
11949,73,237,0.0,932,12022,0.006072200964897688,0.01971385792713359,622
28948,44,286,0.0,530,28992,0.0015176600441501103,0.009864790286975718,200
92198,233,393,32566.0,791,92431,0.002520799298936504,0.0042518202767469785,165
7179,14,2,70136.0,297,7193,0.0019463367162519116,0.00027804810232170165,281
10742,51,157,3527.0,232,10793,0.004725284906884092,0.01454646530158436,24
2106614,863,625,10490226.0,2794,2107477,0.000409494385941104,0.00029656314161435686,1306
1195528,701,383,3717029.0,1916,1196229,0.0005860081974270813,0.0003201728097212156,832
29570,30,153,0.0,241,29600,0.0010135135135135136,0.005168918918918919,58
1463023,768,858,12195092.0,2723,1463791,0.0005246650648897281,0.0005861492521814931,1097
243414,690,365,508988.0,1445,244104,0.0028266640448333497,0.0014952643135712647,390
19651,35,54,15798.0,130,19686,0.0017779132378339937,0.0027430661383724473,41
54304,59,878,60742.0,1026,54363,0.0010852969850817652,0.01615069072714898,89
80111,249,131,450496.0,522,80360,0.0030985564957690392,0.0016301642608262817,142
187237,523,388,417746.0,1169,187760,0.0027854708138048572,0.002066467831273967,258
23542,104,51,0.0,254,23646,0.004398206884885393,0.0021568129916264907,99
23887,26,101,0.0,149,23913,0.0010872747041358257,0.004223644042989169,22
