match,insertion,deletion,soft_clipping,NM,lengths,INS_readLength,DEL_readLength,NM_INS_DEL
1896396,1642,1501,11105001.0,5844,1898038,0.0008651038598805715,0.000790816622217258,2701
31386,27,167,0.0,212,31413,0.0008595167605768313,0.005316270333938179,18
5336,7,10,13982.0,289,5343,0.0013101253977166386,0.0018716077110237693,272
13552,15,109,1592.0,230,13567,0.0011056239404437238,0.00803420063389106,106
5296049,9440,8054,53168136.0,25026,5305489,0.0017792893360065397,0.0015180504568004947,7532
1187341,758,520,2746252.0,2649,1188099,0.0006379939718828145,0.00043767396488003104,1371
18359,78,59,0.0,151,18437,0.004230623203341107,0.0032000867820144276,14
19486,42,199,0.0,425,19528,0.0021507578861122492,0.010190495698484228,184
28527,40,263,0.0,402,28567,0.0014002170336402141,0.009206426996184408,99
28335,23,312,0.0,786,28358,0.000811058607800268,0.011002186331899288,451
34510,40,50,0.0,95,34550,0.0011577424023154848,0.001447178002894356,5
44212,51,379,0.0,896,44263,0.0011522038723087002,0.008562456227548969,466
27226,202,607,1870.0,1750,27428,0.007364736765349278,0.022130669388945604,941
37995,40,124,0.0,180,38035,0.0010516629420270803,0.003260155120283949,16
19551,28,294,19627.0,755,19579,0.0014301036825169824,0.015016088666428316,433
20486,43,355,22795.0,1066,20529,0.0020945978859174827,0.0172926104535048,668
63637,201,465,7605.0,1866,63838,0.0031485948807920047,0.0072840627839218025,1200
96473,89,109,0.0,331,96562,0.0009216876203889729,0.0011288084339595285,133
23393,26,111,0.0,276,23419,0.0011102096588240318,0.004739741235748751,139
20529,196,212,7387.0,1090,20725,0.00945717732207479,0.0102291917973462,682
17325,48,101,51774.0,683,17373,0.0027629079606285617,0.005813618833822598,534
22061,155,298,10820.0,1364,22216,0.006976953546993158,0.013413755851638459,911
27083,71,459,0.0,685,27154,0.002614716063931649,0.01690358694851587,155
19075,248,199,29160.0,1270,19323,0.012834445996998395,0.010298607876623712,823
49074,56,187,0.0,463,49130,0.001139833095868105,0.0038062283737024223,220
39089,278,114,0.0,552,39367,0.00706175222902431,0.002895826453628674,160
28143,13,55,15.0,179,28156,0.00046171331154993607,0.001953402471942037,111
17593,32,45,0.0,90,17625,0.0018156028368794327,0.002553191489361702,13
35019,51,89,15540.0,462,35070,0.0014542343883661248,0.0025377815796977475,322
21208,38,42,2150.0,133,21246,0.0017885719664878096,0.001976842699802316,53
31262,17,31,12.0,117,31279,0.0005434956360497458,0.0009910802775024777,69
1394962,12947,12404,6106581.0,31866,1407909,0.009195906837728859,0.008810228501984149,6515
34456,37,16,0.0,78,34493,0.0010726814136201549,0.0004638622329168237,25
1311353,1231,1055,5535509.0,3769,1312584,0.000937844739841412,0.0008037580832921931,1483
12614,33,15,6825.0,57,12647,0.0026093144619277297,0.0011860520281489681,9
196301,94,116,364808.0,737,196395,0.0004786272562947122,0.000590646401384964,527
19922,125,131,0.0,881,20047,0.006235346934703447,0.006534643587569213,625
25768,19,271,1827.0,935,25787,0.0007368053670454104,0.010509171287858223,645
42259,43,412,0.0,1665,42302,0.0010165004018722519,0.009739492222589949,1210
27855,18,191,348.0,942,27873,0.0006457862447529867,0.006852509597101137,733
14239,29,92,0.0,487,14268,0.0020325203252032522,0.006447995514437903,366
28708,40,65,8891.0,900,28748,0.0013914011409489355,0.0022610268540420204,795
12757,19,9,0.0,478,12776,0.0014871634314339386,0.000704445835942392,450
15131,35,39,1016.0,579,15166,0.002307793749175788,0.002571541606224449,505
18333,86,93,0.0,629,18419,0.004669091698789294,0.005049134046365166,450
13248,17,24,1172.0,508,13265,0.0012815680361854503,0.0018092725216735772,467
29824,40,106,12064.0,997,29864,0.001339405304045004,0.0035494240557192606,851
12166,15,102,0.0,409,12181,0.001231425991297923,0.008373696740825876,292
14496,218,72,3.0,629,14714,0.014815821666440125,0.0048932988990077475,339
35080,45,56,0.0,1262,35125,0.001281138790035587,0.001594306049822064,1161
16779,21,174,946.0,694,16800,0.00125,0.010357142857142856,499
19366,280,164,0.0,940,19646,0.014252265092130713,0.00834775526824799,496
14926,54,60,0.0,686,14980,0.003604806408544726,0.004005340453938585,572
14308,10,212,995.0,623,14318,0.0006984215672579969,0.014806537225869535,401
23961,46,56,0.0,909,24007,0.0019161078018911152,0.0023326529762152707,807
19406,30,74,1370.0,617,19436,0.0015435274747890512,0.0038073677711463264,513
16068,17,111,0.0,552,16085,0.001056885296860429,0.006900839291265154,424
19853,85,115,0.0,1318,19938,0.004263215969505467,0.005767880429330926,1118
29769,54,123,0.0,920,29823,0.00181068302987627,0.004124333568051504,743
13467,7,29,0.0,420,13474,0.0005195190737717084,0.0021522933056256494,384
12302,13,60,0.0,361,12315,0.0010556232237109216,0.0048721071863581,288
13492,11,82,0.0,441,13503,0.0008146337850847959,0.006072724579723025,348
12061,30,75,0.0,446,12091,0.0024811843519973536,0.006202960879993383,341
12554,20,173,13.0,478,12574,0.001590583744234134,0.013758549387625258,285
10419,21,69,0.0,321,10440,0.002011494252873563,0.0066091954022988505,231
12292,12,49,0.0,378,12304,0.0009752925877763329,0.003982444733420026,317
25522,86,94,2.0,825,25608,0.0033583255232739768,0.0036707278975320213,645
12925,37,52,21.0,444,12962,0.0028544977626909426,0.004011726585403487,355
13018,47,111,0.0,481,13065,0.0035973976272483735,0.008495981630309988,323
23260,179,169,2.0,873,23439,0.007636844575280515,0.007210205213533,525
29950,6,115,0.0,810,29956,0.00020029376418747495,0.00383896381359327,689
15864,106,203,0.0,698,15970,0.006637445209768315,0.012711333750782717,389
13861,157,149,0.0,634,14018,0.011199885861035812,0.010629191040091312,328
27336,66,117,0.0,863,27402,0.00240858331508649,0.004269761331289687,680
24165,74,214,0.0,901,24239,0.003052931226535748,0.008828747060522299,613
24129,107,154,0.0,939,24236,0.004414919953787753,0.006354183858722561,678
23383,10,307,929.0,828,23393,0.0004274783054759971,0.01312358397811311,511
27634,370,141,10394.0,1215,28004,0.013212398228824454,0.0050349950007141835,704
25027,28,126,0.0,817,25055,0.001117541408900419,0.005028936340051885,663
21454,13,117,8.0,654,21467,0.0006055806586854241,0.005450225928168817,524
21745,47,180,2251.0,842,21792,0.0021567547723935388,0.008259911894273128,615
21038,128,244,0.0,936,21166,0.006047434564868185,0.011527922139279978,564
15171,231,85,0.0,863,15402,0.014998052201012855,0.005518763796909493,547
19664,36,40,0.0,654,19700,0.0018274111675126903,0.0020304568527918783,578
17852,15,94,0.0,583,17867,0.0008395365758101528,0.005261095875076957,474
18005,41,45,0.0,557,18046,0.0022719716280616203,0.0024936273966529978,471
16390,30,145,0.0,573,16420,0.0018270401948842874,0.008830694275274055,398
17362,19,18,0.0,553,17381,0.0010931476900063288,0.0010356136010586272,516
16521,33,35,0.0,514,16554,0.0019934758970641536,0.002114292618098345,446
15552,20,94,18.0,491,15572,0.0012843565373747753,0.006036475725661444,377
15376,24,222,0.0,639,15400,0.0015584415584415584,0.014415584415584416,393
16187,10,59,0.0,490,16197,0.0006173982836327715,0.0036426498734333517,421
27426,232,409,0.0,1321,27658,0.008388169788126402,0.014787764841998698,680
14251,47,46,0.0,415,14298,0.003287173031193174,0.0032172331794656597,322
13054,49,42,5387.0,416,13103,0.0037396016179500878,0.0032053728153857894,325
13969,38,44,8332.0,584,14007,0.0027129292496608838,0.003141286499607339,502
21031,40,217,0.0,713,21071,0.0018983436951260026,0.010298514546058565,456
21368,38,57,0.0,567,21406,0.001775203214052135,0.0026628048210782023,472
15443,8,76,0.0,411,15451,0.0005177658403986797,0.004918775483787457,327
16243,18,103,4.0,476,16261,0.0011069429924358896,0.006334173790049812,355
16639,19,111,0.0,483,16658,0.0011405931084163764,0.0066634650018009365,353
16544,6,157,5246.0,511,16550,0.00036253776435045317,0.009486404833836858,348
16615,21,125,0.0,505,16636,0.001262322673719644,0.007513825438807405,359
14088,10,61,0.0,404,14098,0.0007093204709887927,0.0043268548730316355,333
17934,24,72,0.0,531,17958,0.0013364517206815904,0.004009355162044771,435
28790,38,476,0.0,1284,28828,0.001318162897183294,0.016511724712085472,770
27671,50,352,0.0,1239,27721,0.0018036867356877458,0.01269795461924173,837
21969,15,191,9.0,680,21984,0.0006823144104803493,0.008688136826783115,474
18115,20,83,0.0,486,18135,0.0011028398125172319,0.004576785221946512,383
30680,51,412,0.0,1485,30731,0.0016595620057921969,0.01340665777228206,1022
33458,25,244,0.0,1115,33483,0.000746647552489323,0.007287280112295792,846
25141,29,331,394.0,972,25170,0.001152165276122368,0.013150576082638062,612
21046,70,294,0.0,1000,21116,0.003315021784428869,0.01392309149460125,636
33624,79,344,263.0,2211,33703,0.002344004984719461,0.010206806515740439,1788
30957,30,197,6608.0,1007,30987,0.000968147933004163,0.006357504760060671,780
24565,37,59,0.0,1278,24602,0.0015039427688805789,0.002398179009836599,1182
22028,11,151,0.0,706,22039,0.0004991152048641046,0.006851490539498162,544
13037,28,202,16.0,519,13065,0.0021431305013394565,0.015461155759663222,289
12409,34,146,4966.0,469,12443,0.002732460017680624,0.011733504781805031,289
23045,22,132,2.0,668,23067,0.0009537434430138292,0.005722460658082976,514
17373,22,112,0.0,534,17395,0.0012647312446105203,0.006438631790744467,400
16632,372,151,2448.0,673,17004,0.021877205363443897,0.00888026346741943,150
10107,28,149,10370.0,230,10135,0.0027627035027133697,0.014701529353724716,53
50271,34,166,0.0,271,50305,0.0006758771493887288,0.0032998707881920285,71
18354,27,109,0.0,337,18381,0.0014689081116370166,0.00593003645068277,201
35483,133,221,0.0,436,35616,0.0037342767295597485,0.0062050763701707095,82
16858,17,241,0.0,297,16875,0.0010074074074074074,0.014281481481481482,39
49460,96,74,44011.0,496,49556,0.0019372023569295342,0.0014932601501331827,326
16331,26,117,0.0,191,16357,0.0015895335330439568,0.007152900898697806,48
41675,40,99,0.0,222,41715,0.0009588876902792761,0.0023732470334412083,83
54520,44,57,13735.0,327,54564,0.0008063924932189722,0.0010446448207609414,226
13926,32,149,0.0,251,13958,0.0022925920618999856,0.010674881788221808,70
12715,18,124,0.0,199,12733,0.001413649571978324,0.00973847482918401,57
10184,12,11,6248.0,67,10196,0.0011769321302471558,0.0010788544527265593,44
9863,8,52,2694.0,96,9871,0.0008104548677945497,0.005267956640664573,36
11393,14,168,0.0,214,11407,0.0012273165600070132,0.01472779872008416,32
11355,14,107,0.0,181,11369,0.0012314187703403993,0.00941155774474448,60
29451,14,32,0.0,210,29465,0.0004751399966061429,0.001086034277956898,164
22157,17,26,31.0,182,22174,0.0007666636601425092,0.0011725444213944258,139
24200,28,41,0.0,259,24228,0.0011556876341423147,0.0016922568928512466,190
16771,12,418,0.0,628,16783,0.000715009235535959,0.024906155037835904,198
17028,45,85,13336.0,410,17073,0.002635740643120717,0.004978621214783576,280
27949,38,291,0.0,571,27987,0.0013577732518669382,0.010397684639296816,242
32208,139,226,0.0,606,32347,0.004297152749868612,0.006986737564534578,241
34612,64,557,5657.0,1523,34676,0.0018456569385165533,0.016062983043026877,902
28972,27,525,7.0,810,28999,0.0009310665885030519,0.018104072554226008,258
19795,18,81,12059.0,287,19813,0.0009084944228536819,0.0040882249028415685,188
22710,363,124,0.0,683,23073,0.015732674554674295,0.005374246955315737,196
22503,17,65,0.0,216,22520,0.0007548845470692718,0.002886323268206039,134
22756,9,261,9073.0,490,22765,0.0003953437294091808,0.011464968152866241,220
15108,108,178,0.0,386,15216,0.007097791798107256,0.011698212407991588,100
37232,77,643,0.0,1121,37309,0.0020638451848079553,0.01723444745235734,401
14666,270,73,2.0,418,14936,0.018077129084092126,0.004887520085698982,75
32331,38,194,2.0,409,32369,0.0011739627421298155,0.005993388736136427,177
23320,15,63,1698.0,172,23335,0.0006428112277694451,0.0026998071566316693,94
15563,1,34,3.0,87,15564,6.425083526085839e-05,0.0021845283988691853,52
43739,8,384,30.0,698,43747,0.00018286968249251378,0.008777744759640662,306
26251,45,402,0.0,603,26296,0.0017112868877395802,0.01528749619714025,156
21546,12,110,0.0,230,21558,0.0005566379070414695,0.005102514147880138,108
20767,30,28,0.0,157,20797,0.0014425157474635764,0.0013463480309660047,99
22253,61,114,0.0,415,22314,0.0027337097786143227,0.005108900242000538,240
17739,56,114,6.0,243,17795,0.0031469513908401235,0.0064062939027816805,73
20794,40,234,16333.0,373,20834,0.001919938561966017,0.0112316405875012,99
18976,12,64,0.0,171,18988,0.0006319780914261639,0.0033705498209395408,95
13822,20,79,18.0,189,13842,0.0014448779078167894,0.0057072677358763185,90
16856,17,50,0.0,134,16873,0.0010075268179932436,0.0029633141705683636,67
15288,16,55,0.0,132,15304,0.0010454783063251437,0.0035938316779926816,61
14698,3,27,7907.0,96,14701,0.00020406775049316373,0.0018366097544384736,66
18318,29,75,0.0,196,18347,0.0015806398866299667,0.004087861775767155,92
13304,5,48,0.0,103,13309,0.000375685626267939,0.0036065820121722143,50
16480,5,31,0.0,96,16485,0.00030330603579011223,0.0018804974218986957,60
50842,267,651,0.0,1711,51109,0.005224128822712243,0.012737482635152321,793
27503,24,47,11871.0,295,27527,0.0008718712536782069,0.001707414538453155,224
15900,45,470,27.0,650,15945,0.0028222013170272815,0.02947632486672938,135
25613,42,58,1183.0,381,25655,0.0016371077762619372,0.00226076788150458,281
21050,2,34,0.0,152,21052,9.500285008550257e-05,0.0016150484514535436,116
13292,682,917,0.0,2044,13974,0.048804923429225704,0.06562186918563045,445
18387,22,86,0.0,265,18409,0.0011950676299636047,0.004671628008039546,157
17694,31,82,0.0,224,17725,0.0017489421720733426,0.0046262341325811005,111
28892,95,75,0.0,434,28987,0.0032773312174423017,0.0025873667506123433,264
22649,18,60,0.0,258,22667,0.0007941059690298672,0.0026470198967662242,180
29781,47,65,20.0,388,29828,0.001575700683921148,0.002179160520316481,276
34574,47,199,0.0,500,34621,0.0013575575517749342,0.00574795644262153,254
12793,27,87,0.0,268,12820,0.0021060842433697348,0.006786271450858034,154
41721,14,405,0.0,619,41735,0.0003354498622259494,0.009704085300107823,200
35102,38,344,0.0,594,35140,0.0010813887307911212,0.009789413773477518,212
36065,14,123,0.0,336,36079,0.0003880373624546135,0.00340918539870839,199
27504,363,1087,112.0,1584,27867,0.013026159974162989,0.039006710446047296,134
23629,97,423,2621.0,764,23726,0.004088341903397117,0.017828542527185368,244
26719,45,357,0.0,575,26764,0.0016813630249589,0.013338813331340607,173
33080,64,125,0.0,353,33144,0.0019309678976587015,0.0037714216751146513,164
30589,20,50,0.0,219,30609,0.0006534025940082983,0.0016335064850207456,149
23859,17,40,812.0,196,23876,0.000712012062321997,0.0016753224995811693,139
25104,39,211,2541.0,364,25143,0.0015511275504116453,0.008391997772739928,114
24121,9,60,50.0,180,24130,0.0003729796933278077,0.0024865312888520514,111
29301,28,93,0.0,253,29329,0.0009546864877766033,0.003170922977258004,132
34000,13,58,2.0,223,34013,0.0003822068032810984,0.0017052303531002852,152
29245,8,29,0.0,179,29253,0.00027347622466071856,0.0009913513143951047,142
23735,15,53,3.0,181,23750,0.0006315789473684211,0.0022315789473684212,113
26846,125,196,0.0,453,26971,0.004634607541433392,0.007267064624967558,132
32420,158,144,0.0,470,32578,0.004849898704647308,0.0044201608447418505,168
27854,7,35,7332.0,166,27861,0.00025124726319945443,0.0012562363159972722,124
17778,7,83,0.0,175,17785,0.0003935901040202418,0.004666854090525724,85
18747,4,22,0.0,114,18751,0.000213321956162338,0.001173270758892859,88
14143,7,71,0.0,146,14150,0.0004946996466431095,0.005017667844522968,68
14985,23,53,0.0,145,15008,0.0015325159914712154,0.003531449893390192,69
13169,8,27,0.0,87,13177,0.0006071184639902861,0.0020490248159672157,52
27987,8,154,0.0,309,27995,0.0002857653152348634,0.00550098231827112,147
27122,12,119,0.0,270,27134,0.0004422495761774895,0.004385641630426771,139
27455,17,406,0.0,572,27472,0.0006188118811881188,0.014778683750728014,149
26571,30,148,0.0,317,26601,0.001127777151234916,0.005563700612758919,139
16673,1,22,0.0,96,16674,5.997361161089121e-05,0.0013194194554396067,73
11827,3,22,0.0,67,11830,0.00025359256128486897,0.0018596787827557058,42
21235,10,185,0.0,324,21245,0.0004706989879971758,0.008707931277947752,129
21304,1,35,0.0,143,21305,4.693733865289838e-05,0.0016428068528514432,107
21216,4,16,8549.0,136,21220,0.00018850141376060322,0.0007540056550424129,116
36307,380,141,0.0,1101,36687,0.010357892441464279,0.003843323248017009,580
12015,29,413,309.0,578,12044,0.0024078379275988045,0.03429093324476918,136
17743,13,380,0.0,516,17756,0.0007321468799279117,0.021401216490200495,123
31429,31,463,0.0,751,31460,0.0009853782581055307,0.014717101080737444,257
35881,27,782,4194.0,1151,35908,0.0007519215773643756,0.0217778767962571,342
26904,26,152,555.0,527,26930,0.0009654660230226513,0.005644262903824731,349
19602,72,138,38.0,424,19674,0.0036596523330283625,0.007014333638304361,214
11702,14,374,0.0,466,11716,0.001194947080914988,0.03192215773301468,78
28347,51,1469,1465.0,1785,28398,0.0017959011197971689,0.051728994999647865,265
14295,300,844,847.0,1249,14595,0.020554984583761562,0.05782802329564919,105
16380,12,727,3309.0,915,16392,0.0007320644216691069,0.04435090287945339,176
11682,16,92,7497.0,212,11698,0.0013677551718242434,0.007864592237989399,104
29488,150,310,0.0,679,29638,0.005061070247655037,0.010459545178487078,219
15531,19,32,26708.0,207,15550,0.0012218649517684887,0.002057877813504823,156
3145300,1886,2206,23753091.0,7276,3147186,0.0005992655025791294,0.0007009436366328523,3184
1818344,865,1151,3389848.0,3728,1819209,0.000475481376796179,0.0006326925603380371,1712
19434,16,203,0.0,488,19450,0.0008226221079691517,0.010437017994858612,269
21040,36,53,0.0,147,21076,0.001708104004554944,0.0025147086733725565,58
31359,33,504,0.0,1125,31392,0.001051223241590214,0.016055045871559634,588
20745,25,396,0.0,701,20770,0.001203659123736158,0.019065960519980742,280
31102,14,40,0.0,104,31116,0.0004499292968247847,0.001285512276642242,50
21355,56,182,9460.0,391,21411,0.0026154780253140907,0.008500303582270795,153
13188,49,127,0.0,315,13237,0.0037017451084082496,0.009594318954445872,139
17258,29,219,0.0,542,17287,0.0016775611731358825,0.012668479204026147,294
27531,10,49,0.0,88,27541,0.00036309502196724884,0.0017791656076395193,29
26293,124,173,0.0,443,26417,0.004693947079532119,0.006548813264185941,146
20761,157,256,6631.0,1104,20918,0.00750549765751984,0.012238263696338082,691
21127,152,105,0.0,1173,21279,0.007143192819211429,0.0049344424080078955,916
21296,108,233,772.0,795,21404,0.005045785834423472,0.010885815735376565,454
24083,121,268,0.0,798,24204,0.004999173690299124,0.011072549991736904,409
17952,74,31,0.0,150,18026,0.0041051814046377455,0.0017197381559968933,45
843310,177,303,2291439.0,945,843487,0.00020984318667626175,0.0003592230822763125,465
502916,302,437,622137.0,1228,503218,0.0006001375149537576,0.0008684109073999738,489
22818,44,59,0.0,177,22862,0.0019245910244073134,0.0025807016009098066,74
24213,37,426,598.0,687,24250,0.0015257731958762887,0.01756701030927835,224
31075,480,430,0.0,1735,31555,0.015211535414355886,0.013627000475360482,825
28578,33,95,0.0,243,28611,0.0011534025374855825,0.0033204012442766767,115
51620,67,236,0.0,487,51687,0.0012962640509218953,0.004565945015187572,184
20002,30,214,0.0,293,20032,0.0014976038338658146,0.010682907348242811,49
22234,102,90,0.0,286,22336,0.0045666189111747855,0.004029369627507163,94
742920,207,406,28509.0,1122,743127,0.00027855265654457446,0.0005463399930294553,509
15784,1,36,8889.0,127,15785,6.335128286347799e-05,0.0022806461830852075,90
2872137,4826,4027,19377189.0,12591,2876963,0.001677463352848125,0.0013997399340902193,3738
5820,54,183,43271.0,482,5874,0.009193054136874362,0.03115423901940756,245
19964,29,9,5727.0,39,19993,0.0014505076776871906,0.0004501575551443005,1
3108224,1258,827,20566861.0,3454,3109482,0.0004045689925202976,0.0002659606969906885,1369
38556,44,29,0.0,131,38600,0.0011398963730569949,0.0007512953367875648,58
2713877,1903,956,15449348.0,4408,2715780,0.0007007194986339099,0.0003520167318413126,1549
5875,19,150,45711.0,428,5894,0.0032236172378690194,0.025449609772650154,259
5947,3,5,8887.0,248,5950,0.0005042016806722689,0.0008403361344537816,240
6112,17,5,10014.0,257,6129,0.0027736988089410997,0.0008157937673356176,235
6113,21,4,16097.0,258,6134,0.0034235409194652757,0.0006521030322791001,233
370759,350,231,53725.0,1079,371109,0.0009431191375040756,0.0006224586307526899,498
116457,177,199,15398.0,886,116634,0.0015175677761201708,0.0017061920194797401,510
32195,69,296,0.0,696,32264,0.0021386064964046617,0.009174311926605505,331
34938,71,101,75307.0,292,35009,0.0020280499300179954,0.0028849724356594018,120
10855,329,116,7577.0,512,11184,0.029417024320457796,0.010371959942775394,67
118577,423,517,104457.0,1141,119000,0.0035546218487394958,0.004344537815126051,201
30934,26,32,0.0,187,30960,0.0008397932816537468,0.0010335917312661498,129
706403,1041,1220,123159.0,3115,707444,0.0014714945635272898,0.0017245181244027795,854
332815,519,674,316494.0,1528,333334,0.001556996886006228,0.002021995956008088,335
175244,77,425,0.0,700,175321,0.00043919439200095823,0.0024241248909143798,198
14286,5,78,0.0,193,14291,0.000349870547897278,0.005457980547197537,110
20496,363,344,4347.0,1329,20859,0.0174025600460233,0.016491682247471117,622
14901,548,716,6445.0,1701,15449,0.035471551556735065,0.04634604181500421,437
28072,592,307,4398.0,1358,28664,0.02065308400781468,0.010710298632430924,459
24882,251,308,0.0,826,25133,0.00998686985238531,0.012254804440377194,267
20740,54,183,0.0,402,20794,0.002596902952774839,0.008800615562181398,165
23892,69,274,0.0,421,23961,0.0028796794791536248,0.011435248946204249,78
343833,302,434,3961.0,1007,344135,0.0008775625844508696,0.0012611329856015807,271
35387,278,409,0.0,691,35665,0.007794756764334782,0.011467825599327072,4
27116,250,432,18497.0,748,27366,0.009135423518234305,0.015786011839508878,66
12646,27,20,0.0,52,12673,0.0021305136905231596,0.0015781582892764145,5
77517,18,715,31456.0,1018,77535,0.00023215322112594313,0.009221641839169407,285
35539,128,36,0.0,193,35667,0.0035887515069952616,0.0010093363613424174,29
18971,16,165,2.0,190,18987,0.0008426818349396956,0.00869015642281561,9
25844,22,217,0.0,316,25866,0.0008505373849841491,0.008389391479161835,77
