match,insertion,deletion,soft_clipping,NM,lengths,INS_readLength,DEL_readLength,NM_INS_DEL
16811,185,389,12399.0,980,16996,0.010884914097434691,0.022887738291362675,406
43396,46,138,0.0,1217,43442,0.0010588831085124994,0.003176649325537498,1033
33141,68,76,54.0,1882,33209,0.0020476376885783976,0.002288536240175856,1738
41332,31,78,0.0,983,41363,0.00074946207963639,0.0018857432971496266,874
24517,34,367,7.0,1402,24551,0.0013848723066270214,0.014948474603885788,1001
35993,42,45,0.0,1149,36035,0.0011655335090883863,0.0012487859025946996,1062
29415,66,126,0.0,1381,29481,0.002238730029510532,0.004273939147247379,1189
18821,5,107,0.0,750,18826,0.00026559014129395517,0.0056836290236906405,638
30389,59,99,0.0,716,30448,0.001937729900157646,0.0032514450867052024,558
22827,16,42,0.0,993,22843,0.000700433393162019,0.0018386376570503,935
19823,15,164,0.0,526,19838,0.0007561246093356185,0.008266962395402762,347
30386,32,330,0.0,910,30418,0.0010520086790716024,0.0108488395029259,548
28541,56,182,0.0,884,28597,0.0019582473686050985,0.00636430394796657,646
31331,81,214,0.0,1698,31412,0.002578632369794983,0.006812683051063288,1403
9073,21,58,8686.0,510,9094,0.0023092148669452387,0.0063778315372773255,431
27147,49,142,0.0,1346,27196,0.001801735549345492,0.005221356081776732,1155
8856,9,74,4472.0,489,8865,0.0010152284263959391,0.008347433728144388,406
22689,90,65,0.0,1049,22779,0.0039510075069142635,0.002853505421660301,894
13557,60,251,0.0,988,13617,0.004406256884776382,0.018432841301314534,677
18161,52,221,1425.0,802,18213,0.0028551034975017845,0.012134189864382585,529
23510,56,139,0.0,592,23566,0.002376304845964525,0.005898328099804804,397
24922,32,280,0.0,1350,24954,0.0012823595415564638,0.01122064598861906,1038
26243,44,77,0.0,568,26287,0.0016738311713014038,0.0029292045497774566,447
23237,43,349,226.0,839,23280,0.0018470790378006872,0.014991408934707904,447
20254,120,218,9745.0,1531,20374,0.00588985962501227,0.010699911652105624,1193
18314,24,105,17524.0,524,18338,0.001308757770749264,0.0057258152470280295,395
23934,10,99,27.0,525,23944,0.000417641162712997,0.0041346475108586704,416
21569,47,235,0.0,1188,21616,0.0021743153219837157,0.010871576609918578,906
13545,33,60,6347.0,689,13578,0.0024304021210782146,0.004418912947414936,596
19449,57,142,0.0,597,19506,0.002922177791448785,0.007279811340100482,398
17111,44,70,0.0,516,17155,0.0025648498979889247,0.004080443019527835,402
16022,9,13,11087.0,337,16031,0.0005614122637390056,0.000810928825400786,315
11060,8,6,17531.0,638,11068,0.0007228044813877846,0.0005421033610408384,624
15120,19,240,0.0,480,15139,0.0012550366602813925,0.01585309465618601,221
13576,18,30,7.0,293,13594,0.0013241135795203766,0.0022068559658672943,245
19905,96,135,18606.0,1610,20001,0.0047997600119994,0.006749662516874156,1379
20055,247,458,10144.0,2477,20302,0.012166289035562999,0.022559353758250418,1772
20041,62,579,16815.0,1702,20103,0.003084116798487788,0.028801671392329503,1061
13102,18,45,18754.0,381,13120,0.001371951219512195,0.003429878048780488,318
13244,34,212,11650.0,789,13278,0.002560626600391625,0.015966259978912486,543
18940,565,599,2241.0,2606,19505,0.02896693155601128,0.03071007433991284,1442
18669,330,509,17105.0,1778,18999,0.017369335228169903,0.02679088373072267,939
19216,291,241,18050.0,1758,19507,0.014917721843440816,0.012354539396114216,1226
16639,93,112,675.0,1041,16732,0.005558211809705953,0.006693760459000717,836
14312,203,407,85.0,1398,14515,0.013985532208060626,0.028039958663451603,788
18641,53,269,17520.0,1567,18694,0.0028351342676794693,0.01438964373595806,1245
17922,15,367,15579.0,702,17937,0.0008362602441879914,0.020460500641132855,320
14072,863,697,12177.0,1867,14935,0.05778372949447606,0.04666889856042852,307
15197,350,735,4.0,1361,15547,0.0225123818099955,0.04727600180099054,276
39390,766,987,0.0,3205,40156,0.01907560513995418,0.024579141348739914,1452
28693,52,171,34.0,797,28745,0.0018090102626543746,0.005948860671421117,574
27262,42,32,0.0,659,27304,0.0015382361558745972,0.0011719894520949312,585
23391,190,418,5457.0,1132,23581,0.008057334294559178,0.017726135448030193,524
21574,40,226,1659.0,721,21614,0.0018506523549551217,0.010456185805496437,455
19850,128,403,483.0,949,19978,0.0064070477525277805,0.020172189408349184,418
16567,47,71,1609.0,488,16614,0.0028289394486577584,0.004273504273504274,370
15249,37,225,94.0,552,15286,0.0024205155043830954,0.014719351040167474,290
23236,128,144,109.0,2202,23364,0.005478513953090224,0.0061633281972265025,1930
16816,55,70,3.0,1189,16871,0.0032600320075869835,0.004149131646019797,1064
17111,65,51,3.0,534,17176,0.003784350256171402,0.002969259431765254,418
19232,41,37,193.0,634,19273,0.00212732838686245,0.0019197841539978207,556
19362,69,252,0.0,703,19431,0.003551026709896557,0.012968967114404817,382
24343,53,178,228.0,847,24396,0.0021724872929988525,0.007296278078373504,616
15575,45,80,64.0,718,15620,0.002880921895006402,0.005121638924455826,593
12505,61,72,374.0,622,12566,0.0048543689320388345,0.005729746936176986,489
17178,54,46,200.0,604,17232,0.0031337047353760445,0.002669452181987001,504
19190,39,12,2.0,403,19229,0.0020281865931665714,0.0006240574132820219,352
15027,47,61,0.0,423,15074,0.0031179514395648137,0.004046702932201141,315
21207,169,161,0.0,720,21376,0.007906062874251498,0.007531811377245509,390
20386,29,159,0.0,592,20415,0.0014205241244183199,0.007788390889052168,404
13484,91,44,0.0,456,13575,0.006703499079189687,0.003241252302025783,321
12719,35,115,0.0,405,12754,0.0027442371020856204,0.009016779049709895,255
39258,1391,1325,195.0,3599,40649,0.034219784004526556,0.03259612782602278,883
23171,520,380,517.0,1310,23691,0.02194926343337132,0.016039846355155967,410
17884,410,645,5130.0,1457,18294,0.022411719689515688,0.035257461462774684,402
30207,495,281,2675.0,1430,30702,0.016122728161031854,0.00915249820858576,654
46149,1077,763,0.0,3479,47226,0.02280523440477703,0.01615635455045949,1639
23532,713,713,176.0,1975,24245,0.029408125386677666,0.029408125386677666,549
49056,2312,3130,126.0,6460,51368,0.04500856564398069,0.060932876498987695,1018
42125,989,1025,0.0,3241,43114,0.022939184487637425,0.02377418008071624,1227
15006,226,85,0.0,1019,15232,0.01483718487394958,0.005580357142857143,708
50803,886,1515,20.0,3532,51689,0.01714097777089903,0.02930991119967498,1131
19141,45,126,136.0,1024,19186,0.002345460231418743,0.00656728864797248,853
48101,1199,860,0.0,2861,49300,0.02432048681541582,0.01744421906693712,802
47642,1367,2255,14918.0,4623,49009,0.027892836009712502,0.046011956987492095,1001
20588,318,169,0.0,1124,20906,0.015210944226537836,0.008083803692719794,637
32184,432,260,0.0,2614,32616,0.013245033112582781,0.007971547706647044,1922
72745,124,213,0.0,4005,72869,0.0017016838436097654,0.0029230536991038713,3668
36842,22,114,0.0,725,36864,0.0005967881944444445,0.0030924479166666665,589
29891,17,51,0.0,550,29908,0.0005684097900227364,0.001705229370068209,482
51984,258,105,3923.0,1255,52242,0.004938555185482945,0.002009877110370966,892
72462,550,397,52.0,2326,73012,0.007533008272612721,0.005437462334958637,1379
34305,1192,2015,87.0,3808,35497,0.03358030256077978,0.05676536045299603,601
19917,215,460,0.0,1421,20132,0.010679515199682098,0.022849195310947746,746
17169,96,261,8607.0,1832,17265,0.005560382276281494,0.015117289313640312,1475
11153,528,70,89.0,815,11681,0.045201609451245614,0.005992637616642411,217
11456,555,376,0.0,1389,12011,0.046207642993922236,0.031304637415702274,458
20877,124,774,1503.0,1333,21001,0.005904480739012428,0.03685538783867435,435
54874,88,111,7795.0,2457,54962,0.001601106218842109,0.002019577162403115,2258
48119,796,466,14.0,3876,48915,0.01627312685270367,0.009526730041909435,2614
25813,114,118,266.0,3253,25927,0.004396960697342539,0.004551240020056312,3021
39024,91,183,0.0,2657,39115,0.0023264732199923303,0.0046785120797647965,2383
32474,86,80,5.0,1464,32560,0.0026412776412776413,0.002457002457002457,1298
27392,148,104,0.0,2290,27540,0.005374001452432825,0.003776325344952796,2038
31393,708,804,0.0,2072,32101,0.022055387682626708,0.025045948724338806,560
40800,1375,1353,42.0,3404,42175,0.03260225251926497,0.03208061647895673,676
39848,104,258,98.0,1897,39952,0.002603123748498198,0.006457749299158991,1535
18262,622,421,0.0,1621,18884,0.032937936877780134,0.022294005507307774,578
31133,31,22,2.0,559,31164,0.0009947375176485689,0.0007059427544602747,506
32457,34,22,0.0,584,32491,0.0010464436305438428,0.0006771105844695454,528
27234,26,103,0.0,567,27260,0.0009537784299339691,0.0037784299339691857,438
28469,18,90,441.0,659,28487,0.0006318671674799031,0.0031593358373995157,551
24797,26,44,8.0,472,24823,0.0010474157031785038,0.0017725496515328526,402
17956,457,205,0.0,956,18413,0.024819421061206756,0.011133438331613534,294
19398,98,139,0.0,1395,19496,0.005026672137874436,0.007129667624128026,1158
19389,529,757,212.0,1622,19918,0.026558891454965358,0.038005823877899386,336
18874,188,390,53.0,892,19062,0.009862553771902214,0.02045955303745672,314
15081,21,416,0.0,752,15102,0.0013905442987683751,0.027546020394649717,315
26080,15,201,2.0,761,26095,0.0005748227629814141,0.007702625023950948,545
19072,163,258,76.0,1688,19235,0.008474135690148167,0.013413049129191577,1267
19697,820,119,640.0,1302,20517,0.03996685675293659,0.005800068236096895,363
29877,1185,900,29.0,3387,31062,0.03814950743673942,0.02897430944562488,1302
15237,649,1228,0.0,2152,15886,0.04085358177011205,0.07730076797179906,275
31124,157,69,0.0,804,31281,0.0050190211310380105,0.002205811834660017,578
16222,330,440,0.0,1028,16552,0.019937167713871436,0.026582890285161913,258
18258,18,396,6235.0,730,18276,0.000984898227183191,0.021667760998030205,316
16173,364,928,3.0,1593,16537,0.022011247505593516,0.05611658704722743,301
17529,9,123,15677.0,413,17538,0.0005131713992473486,0.007013342456380431,281
17952,46,49,37.0,876,17998,0.002555839537726414,0.002722524724969441,781
27342,25,212,39.0,844,27367,0.0009135089706580918,0.007746556071180619,607
15923,476,217,0.0,958,16399,0.02902616013171535,0.013232514177693762,265
25252,233,32,0.0,725,25485,0.00914263292132627,0.0012556405728860113,460
13523,377,616,0.0,1250,13900,0.02712230215827338,0.04431654676258993,257
22664,76,94,50.0,1875,22740,0.003342128408091469,0.004133685136323659,1705
20410,146,374,0.0,1091,20556,0.007102549134072777,0.0181942012064604,571
26391,778,473,45.0,1729,27169,0.028635577312378077,0.017409547646214437,478
15122,124,202,2198.0,758,15246,0.008133280860553588,0.013249376885740523,432
9878,65,92,3696.0,445,9943,0.0065372623956552346,0.009252740621542794,288
10108,43,79,2198.0,503,10151,0.004236035858536105,0.007782484484287262,381
12585,96,126,6209.0,690,12681,0.007570380884788266,0.0099361249112846,468
12791,198,318,14140.0,1118,12989,0.015243667718839017,0.02448225421510509,602
12819,278,281,5838.0,1159,13097,0.02122623501565244,0.02145529510574941,600
11338,70,100,2618.0,506,11408,0.006136044880785414,0.00876577840112202,336
18870,552,617,249.0,1872,19422,0.02842137781896818,0.031768098033158276,703
16205,364,486,8703.0,1456,16569,0.021968736797634135,0.02933188484519283,606
14669,232,35,12.0,770,14901,0.015569424870814039,0.002348835648614187,503
14770,239,91,2279.0,834,15009,0.015923779065893796,0.006063028849357052,504
12183,214,86,327.0,822,12397,0.017262240864725338,0.006937162216665322,522
13127,220,28,6428.0,628,13347,0.016483104817562,0.0020978497040533453,380
10902,193,213,11001.0,806,11095,0.017395223073456513,0.019197836863452004,400
9412,23,36,1393.0,354,9435,0.0024377318494965554,0.0038155802861685214,295
9635,20,48,10037.0,279,9655,0.0020714655618850335,0.004971517348524081,211
8814,14,75,2578.0,250,8828,0.0015858631626642502,0.008495695514272768,161
8366,18,30,9333.0,326,8384,0.0021469465648854963,0.00357824427480916,278
12851,68,258,14443.0,830,12919,0.005263565291431225,0.01997058595866553,504
8124,18,60,10203.0,356,8142,0.002210759027266028,0.007369196757553427,278
8161,12,31,6565.0,293,8173,0.0014682491129328276,0.0037929768750764713,250
7802,12,17,27615.0,217,7814,0.0015357051446122344,0.0021755822882006653,188
7266,61,6,8741.0,268,7327,0.00832537191210591,0.0008188890405350075,201
7229,14,22,7005.0,228,7243,0.0019329007317409914,0.0030374154355929865,192
15562,702,445,15466.0,1818,16264,0.043162813575996065,0.02736104279390064,671
14165,376,471,3465.0,1545,14541,0.02585791898768998,0.03239116979574995,698
11149,12,82,5078.0,397,11161,0.001075172475584625,0.007347011916494938,303
10083,11,209,7529.0,543,10094,0.001089756290865861,0.020705369526451356,323
12853,196,277,6076.0,939,13049,0.015020308069583876,0.02122768028201395,466
9656,23,265,5197.0,652,9679,0.0023762785411716087,0.027378861452629404,364
9308,18,613,20611.0,1006,9326,0.0019300879262277503,0.06573021659875616,375
9556,527,372,12737.0,1277,10083,0.05226619061787167,0.03689378161261529,378
12530,200,441,13703.0,1148,12730,0.015710919088766692,0.034642576590730556,507
16717,541,532,5951.0,1716,17258,0.03134778073936725,0.030826283462741917,643
12804,203,301,18676.0,924,13007,0.015606980856461904,0.023141385407857307,420
8327,17,72,5971.0,338,8344,0.002037392138063279,0.00862895493767977,249
12166,30,90,3002.0,441,12196,0.002459822892751722,0.007379468678255166,321
11386,17,81,12801.0,405,11403,0.0014908357449793914,0.007103393843725336,307
11537,17,64,5790.0,410,11554,0.0014713519127574866,0.005539207200969361,329
10787,14,32,7181.0,344,10801,0.0012961762799740765,0.0029626886399407464,298
10523,196,254,1453.0,898,10719,0.018285287806698386,0.02369624032092546,448
12480,16,40,8571.0,389,12496,0.0012804097311139564,0.003201024327784891,333
13258,57,76,12842.0,474,13315,0.004280886218550507,0.005707848291400676,341
13311,16,23,12661.0,386,13327,0.0012005702708786673,0.0017258197643880843,347
12120,69,52,7356.0,452,12189,0.005660841742554762,0.004266141603084748,331
12993,19,54,1482.0,456,13012,0.0014601905932984938,0.004150015370427298,383
13309,16,25,8201.0,395,13325,0.001200750469043152,0.001876172607879925,354
9675,20,32,11063.0,332,9695,0.0020629190304280558,0.003300670448684889,280
8048,41,23,19402.0,323,8089,0.005068611694894301,0.0028433675361602176,259
11576,14,26,10442.0,379,11590,0.0012079378774805867,0.0022433132010353752,339
11561,32,41,10377.0,406,11593,0.002760286379711895,0.0035366169240058655,333
11525,20,77,8204.0,421,11545,0.0017323516673884798,0.006669553919445647,324
11453,19,27,357.0,360,11472,0.0016562064156206415,0.0023535564853556486,314
14952,229,255,3515.0,1037,15181,0.015084645280284567,0.0167973124300112,553
8111,17,84,6245.0,310,8128,0.0020915354330708663,0.01033464566929134,209
11348,9,49,677.0,354,11357,0.0007924627982741922,0.004314519679492824,296
13069,12,61,1914.0,381,13081,0.0009173610580230869,0.004663252044950692,308
10757,235,478,8705.0,1165,10992,0.021379184861717613,0.04348617176128093,452
7917,116,40,7736.0,311,8033,0.01444043321299639,0.004979459728619445,155
7561,10,18,7866.0,152,7571,0.001320829480914014,0.002377493065645225,124
10387,200,326,5052.0,952,10587,0.018891092849721357,0.03079248134504581,426
10461,186,252,5787.0,882,10647,0.017469709777402084,0.023668639053254437,444
10297,190,282,1823.0,883,10487,0.01811766949556594,0.026890435777629448,411
10616,11,97,7700.0,401,10627,0.0010350992754305072,0.009127693610614473,293
8049,14,48,6086.0,275,8063,0.0017363264293687214,0.005953119186407045,213
10544,11,169,12480.0,469,10555,0.0010421601136901943,0.016011369019422076,289
9717,11,37,3801.0,304,9728,0.0011307565789473685,0.003803453947368421,256
10615,13,99,9616.0,388,10628,0.0012231840421528038,0.00931501693639443,276
9805,16,79,1853.0,352,9821,0.0016291619997963547,0.008043987373994501,257
13400,189,247,13119.0,934,13589,0.013908308190448157,0.018176466259474576,498
17290,849,919,4582.0,2346,18139,0.046805226307955236,0.0506643144605546,578
12402,211,294,7194.0,979,12613,0.016728771902005866,0.023309284071989216,474
15234,21,290,227.0,686,15255,0.0013765978367748278,0.01901016060308096,375
10033,193,237,6975.0,847,10226,0.018873459808331702,0.023176217484842557,417
12184,428,262,6535.0,1161,12612,0.033935934031081506,0.020773866159213446,471
12409,17,22,925.0,347,12426,0.0013680991469499438,0.0017704812489940447,308
15941,13,24,12420.0,420,15954,0.0008148426726839664,0.001504324934185784,383
10688,10,25,8536.0,326,10698,0.0009347541596560105,0.002336885399140026,291
10541,25,19,2909.0,318,10566,0.00236607987885671,0.0017982207079310997,274
9356,13,30,2671.0,282,9369,0.001387554701675739,0.003202049311559398,239
7501,11,10,7568.0,228,7512,0.0014643237486687967,0.0013312034078807242,207
10670,11,43,7605.0,338,10681,0.0010298661174047373,0.00402584027712761,284
10679,13,34,2123.0,331,10692,0.0012158623269734382,0.0031799476243920687,284
12426,15,20,13934.0,342,12441,0.0012056908608632747,0.0016075878144843662,307
15434,187,210,5045.0,958,15621,0.011971064592535689,0.013443441521029383,561
15431,211,213,9731.0,988,15642,0.013489323615905895,0.013617184503260453,564
7466,36,45,11828.0,294,7502,0.004798720341242335,0.005998400426552919,213
15332,12,121,411.0,415,15344,0.0007820646506777894,0.007885818561001044,282
7391,8,54,8883.0,256,7399,0.0010812271928639006,0.007298283551831329,194
15818,15,81,911.0,461,15833,0.0009473883660708647,0.005115897176782669,365
7418,12,27,8640.0,237,7430,0.0016150740242261105,0.0036339165545087484,198
10548,24,99,6837.0,398,10572,0.0022701475595913734,0.009364358683314415,275
13871,63,107,6204.0,757,13934,0.004521314769628248,0.0076790584182575,587
9145,16,69,8510.0,312,9161,0.0017465342211548957,0.007531928828730488,227
8591,19,133,6733.0,377,8610,0.0022067363530778165,0.015447154471544716,225
10627,11,20,7896.0,312,10638,0.0010340289528106787,0.0018800526414739613,281
9062,18,27,13492.0,266,9080,0.001982378854625551,0.002973568281938326,221
10307,11,35,5964.0,270,10318,0.0010660980810234541,0.0033921302578018998,224
10189,32,95,3903.0,339,10221,0.0031308091184815575,0.009294589570492125,212
9663,16,66,2095.0,381,9679,0.0016530633329889452,0.006818886248579399,299
9680,14,50,11109.0,350,9694,0.0014441922838869404,0.0051578295853105015,286
9685,20,42,4469.0,364,9705,0.0020607934054611026,0.004327666151468315,302
11432,20,28,16692.0,356,11452,0.0017464198393293748,0.0024449877750611247,308
14621,19,38,15390.0,462,14640,0.0012978142076502733,0.0025956284153005466,405
11435,20,25,18317.0,354,11455,0.001745962461807071,0.002182453077258839,309
13309,19,24,9967.0,409,13328,0.0014255702280912366,0.001800720288115246,366
14935,32,44,3866.0,461,14967,0.002138037014765818,0.002939800895303,385
11404,57,46,3556.0,411,11461,0.00497338801151732,0.004013611377715731,308
10108,199,218,250.0,752,10307,0.019307266905986224,0.021150674299020084,335
14034,21,28,10196.0,359,14055,0.0014941302027748132,0.001992173603699751,310
9042,9,64,5940.0,245,9051,0.0009943652635067948,0.007071041873826097,172
8964,10,37,7482.0,215,8974,0.0011143302874972142,0.004123022063739693,168
8902,18,22,10773.0,216,8920,0.002017937219730942,0.002466367713004484,176
5582,18,4,9112.0,113,5600,0.0032142857142857142,0.0007142857142857143,91
10829,201,117,14621.0,650,11030,0.018223028105167724,0.010607434270172257,332
13145,191,322,10452.0,1021,13336,0.014322135572885423,0.024145170965806838,508
12048,31,94,2773.0,442,12079,0.0025664376190081962,0.007782101167315175,317
13726,18,62,6133.0,422,13744,0.001309662398137369,0.004511059371362049,342
12093,18,49,7841.0,384,12111,0.0014862521674510775,0.004045908678061267,317
8515,14,21,7237.0,297,8529,0.0016414585531715324,0.0024621878297572987,262
11119,19,25,1408.0,346,11138,0.0017058717902675524,0.002244568145088885,302
12123,18,19,6236.0,357,12141,0.0014825796886582653,0.001564945226917058,320
9923,16,24,5386.0,226,9939,0.001609819901398531,0.0024147298520977964,186
7729,14,417,11311.0,594,7743,0.0018080847216841018,0.053855094924447885,163
11983,20,62,0.0,308,12003,0.0016662501041406314,0.0051653753228359574,226
11597,17,38,6895.0,279,11614,0.0014637506457723438,0.0032719132081970035,224
12462,228,241,3050.0,859,12690,0.017966903073286054,0.018991331757289204,390
7778,19,27,7763.0,205,7797,0.00243683468000513,0.0034628703347441324,159
6745,11,32,10140.0,208,6756,0.0016281823564239194,0.004736530491415038,165
6673,32,27,7189.0,209,6705,0.004772557792692021,0.004026845637583893,150
10253,11,53,2997.0,262,10264,0.0010717069368667187,0.005163678877630553,198
11540,19,63,1928.0,439,11559,0.001643740808028376,0.005450298468725669,357
13642,217,548,1717.0,1425,13859,0.015657695360415613,0.03954109243091132,660
17119,539,595,9799.0,1794,17658,0.030524408200249178,0.033695775285989354,660
11341,191,262,15939.0,955,11532,0.016562608394033992,0.022719389524800553,502
11531,13,72,4075.0,435,11544,0.0011261261261261261,0.006237006237006237,350
11670,197,254,3344.0,916,11867,0.016600657284907727,0.021403893149068848,465
11434,17,28,7918.0,384,11451,0.0014845864989957208,0.0024452012924635405,339
11410,61,52,4930.0,462,11471,0.00531775782407811,0.00453317060413216,349
11421,21,35,12198.0,392,11442,0.0018353434714210803,0.0030589057857018003,336
11439,13,23,16355.0,372,11452,0.0011351728955640936,0.002008382815228781,336
11580,13,23,3205.0,402,11593,0.0011213663417579574,0.0019839558354179244,366
8330,14,75,6818.0,342,8344,0.0016778523489932886,0.00898849472674976,253
10943,19,31,7688.0,383,10962,0.0017332603539500092,0.002827951103813173,333
8170,22,31,5504.0,290,8192,0.002685546875,0.0037841796875,237
11302,40,48,0.0,309,11342,0.0035267148651031564,0.004232057838123787,221
11517,20,30,2050.0,277,11537,0.0017335529167027824,0.0026003293750541737,227
7668,10,107,3330.0,264,7678,0.0013024225058609013,0.013935920812711644,147
16265,380,386,4312.0,1188,16645,0.022829678582156804,0.023190147191348754,422
10222,7,29,1753.0,261,10229,0.000684328868902141,0.002835076742594584,225
10498,9,30,9863.0,335,10507,0.0008565718092700105,0.002855239364233368,296
10190,12,17,15836.0,346,10202,0.001176239952950402,0.0016663399333464027,317
10390,11,19,3612.0,243,10401,0.0010575906162868954,0.0018267474281319104,213
10191,18,22,10733.0,246,10209,0.001763150161622098,0.002154961308649231,206
8837,10,32,6017.0,215,8847,0.0011303266644060134,0.003617045326099243,173
8787,15,77,4600.0,374,8802,0.0017041581458759373,0.008748011815496478,282
8284,20,157,3800.0,371,8304,0.0024084778420038534,0.01890655105973025,194
15261,926,582,5270.0,2148,16187,0.0572064001976895,0.035954778525977636,640
12387,192,268,9900.0,964,12579,0.015263534462198903,0.0213053501868193,504
16293,360,522,131.0,1259,16653,0.021617726535759323,0.03134570347685102,377
13098,194,61,6696.0,596,13292,0.014595245260306951,0.00458922660246765,341
9160,190,57,12256.0,478,9350,0.020320855614973262,0.006096256684491978,231
8814,355,241,14448.0,915,9169,0.03871741738466572,0.026284218562547715,319
10372,177,33,6903.0,460,10549,0.016778841596359846,0.0031282586027111575,250
8496,173,41,15388.0,428,8669,0.01995616564771023,0.0047294959049486674,214
6769,186,10,14818.0,399,6955,0.02674335010783609,0.0014378145219266715,203
6846,181,144,12634.0,575,7027,0.02575779137612068,0.02049238650917888,250
8447,200,22,9842.0,425,8647,0.023129409043598937,0.002544234994795883,203
9448,177,53,10927.0,381,9625,0.01838961038961039,0.005506493506493506,151
17309,724,721,5728.0,2246,18033,0.04014861642544224,0.03998225475517107,801
10682,58,134,7934.0,639,10740,0.005400372439478585,0.012476722532588455,447
9406,183,12,5931.0,457,9589,0.01908436750443216,0.001251433934716863,262
9979,231,49,4793.0,558,10210,0.022624877571008815,0.0047992164544564155,278
11021,360,249,4116.0,952,11381,0.03163166681310957,0.021878569545734118,343
13387,17,64,977.0,332,13404,0.0012682781259325574,0.004774694121157864,251
14779,189,22,8268.0,516,14968,0.012626937466595404,0.001469802244788883,305
14366,185,59,7423.0,627,14551,0.01271390282454814,0.004054704144045082,383
16004,363,229,1006.0,1060,16367,0.022178774363047597,0.013991568399828925,468
15904,209,270,6160.0,1127,16113,0.012970893067709302,0.01675665611617948,648
14425,181,67,8081.0,556,14606,0.012392167602355196,0.0045871559633027525,308
13514,227,52,0.0,550,13741,0.01651990393712248,0.003784295175023652,271
13549,185,26,4589.0,467,13734,0.01347021989223824,0.0018931119848551042,256
13361,200,70,437.0,521,13561,0.014748174913354473,0.005161861219674066,251
12413,186,22,8553.0,535,12599,0.01476307643463767,0.001746170330978649,327
12412,188,23,17018.0,533,12600,0.014920634920634921,0.0018253968253968255,322
10430,359,136,7177.0,773,10789,0.03327463156919084,0.012605431457966448,278
9174,197,37,13502.0,416,9371,0.021022302849215666,0.003948351296553196,182
12170,211,35,12.0,473,12381,0.017042242145222517,0.00282691220418383,227
7569,203,82,5209.0,420,7772,0.026119402985074626,0.010550694801852806,135
8175,217,42,3991.0,520,8392,0.025857959961868446,0.005004766444232603,261
22873,230,360,1274.0,1177,23103,0.00995541704540536,0.015582391897156213,587
12514,195,123,13977.0,647,12709,0.015343457392399087,0.00967818081674404,329
10928,35,84,3033.0,332,10963,0.003192556781902764,0.007662136276566633,213
10380,22,46,1085.0,260,10402,0.0021149778888675257,0.004422226494904826,192
12888,24,24,4004.0,322,12912,0.0018587360594795538,0.0018587360594795538,274
12950,27,144,5052.0,395,12977,0.002080604145796409,0.011096555444247515,224
14844,317,504,3333.0,1572,15161,0.020908911021700415,0.03324318976320823,751
13379,24,624,1999.0,1105,13403,0.0017906438856972319,0.04655674102812803,457
11802,191,323,13570.0,872,11993,0.01592595680813808,0.026932377220045028,358
13448,191,240,6494.0,813,13639,0.014003959234547987,0.017596597991055063,382
18440,880,832,4472.0,2322,19320,0.045548654244306416,0.043064182194616975,610
15950,874,701,5140.0,2095,16824,0.05194959581550167,0.041666666666666664,520
12817,193,631,638.0,1147,13010,0.014834742505764796,0.048501152959262106,323
10491,193,74,3363.0,541,10684,0.01806439535754399,0.006926244852115313,274
11531,194,218,2069.0,807,11725,0.016545842217484008,0.01859275053304904,395
13559,209,202,6860.0,870,13768,0.015180127832655432,0.014671702498547356,459
11682,202,193,2984.0,817,11884,0.01699764389094581,0.016240323123527432,422
11385,207,275,11650.0,817,11592,0.017857142857142856,0.023723257418909592,335
10666,195,43,3134.0,533,10861,0.017954147868520395,0.003959119786391676,295
10071,190,40,3431.0,429,10261,0.018516713770587664,0.003898255530650034,199
9388,237,20,5368.0,540,9625,0.024623376623376624,0.002077922077922078,283
9466,196,7,8469.0,404,9662,0.020285655143862553,0.000724487683709377,201
13257,354,203,11933.0,874,13611,0.026008375578576153,0.01491440746455073,317
13164,359,296,7194.0,975,13523,0.026547363750647045,0.021888634178806477,320
9770,357,245,680.0,830,10127,0.03525229584279648,0.02419275204897798,228
13585,354,202,11164.0,858,13939,0.025396369897410145,0.014491713896262286,302
14719,538,310,286.0,1170,15257,0.03526250245788818,0.02031854230844858,322
16412,519,243,1247.0,1100,16931,0.030653830252200108,0.014352371389758431,338
11956,352,180,11190.0,814,12308,0.028599285017874555,0.014624634384140396,282
13122,362,227,5586.0,893,13484,0.026846633046573715,0.01683476713141501,304
13377,359,240,3518.0,989,13736,0.026135701805474663,0.017472335468841003,390
13215,370,196,11796.0,932,13585,0.027235921972764077,0.014427677585572323,366
11572,352,194,9620.0,789,11924,0.02952029520295203,0.016269708151626972,243
15933,706,749,628.0,1875,16639,0.04243043452130537,0.04501472444257468,420
14762,535,295,3116.0,1156,15297,0.03497417794338759,0.01928482709027914,326
7283,5,10,7197.0,205,7288,0.0006860592755214051,0.0013721185510428102,190
12549,385,193,0.0,952,12934,0.029766506881088603,0.014921911241688573,374
9685,31,246,9237.0,447,9716,0.0031906134211609717,0.025319061342116096,170
8647,352,342,11510.0,859,8999,0.039115457273030334,0.038004222691410156,165
11923,368,39,8078.0,613,12291,0.02994060694817346,0.003173053453746644,206
11885,354,55,5897.0,757,12239,0.02892393169376583,0.004493831195359098,348
15167,362,75,9721.0,800,15529,0.0233112241612467,0.004829673514070449,363
11680,459,55,7790.0,751,12139,0.037812010874042346,0.004530850976192438,237
15187,402,140,1049.0,1167,15589,0.02578741420232215,0.00898069151324652,625
9939,349,28,9237.0,569,10288,0.03392301710730949,0.0027216174183514776,192
12866,17,48,5857.0,299,12883,0.0013195684235038424,0.0037258402545990842,234
7919,6,11,6670.0,164,7925,0.0007570977917981072,0.00138801261829653,147
15457,383,389,5795.0,1241,15840,0.02417929292929293,0.024558080808080807,469
8474,20,61,2039.0,236,8494,0.0023546032493524842,0.007181539910525076,155
15682,364,336,7481.0,1291,16046,0.022684781253895052,0.020939798080518508,591
25584,541,494,13095.0,1724,26125,0.020708133971291866,0.01890909090909091,689
12063,183,217,2381.0,678,12246,0.014943655071043607,0.01772007186019925,278
12429,20,51,1002.0,272,12449,0.0016065547433528797,0.004096714595549843,201
14141,50,184,13486.0,747,14191,0.0035233598759777324,0.012965964343598054,513
10671,17,48,6475.0,306,10688,0.001590568862275449,0.004491017964071856,241
10675,11,44,8017.0,285,10686,0.001029384241063073,0.004117536964252292,230
10693,11,26,13393.0,282,10704,0.0010276532137518685,0.002428998505231689,245
10377,11,35,15251.0,227,10388,0.001058914131690412,0.0033692722371967657,181
20111,676,598,0.0,1826,20787,0.032520325203252036,0.028767979987492184,552
20133,177,83,11695.0,528,20310,0.008714918759231905,0.004086656819300837,268
12911,11,46,0.0,234,12922,0.0008512614146416964,0.003559820461228912,177
10689,10,70,5401.0,233,10699,0.0009346667912889055,0.006542667539022338,153
11421,38,69,2838.0,344,11459,0.0033161706955231697,0.006021467841871018,237
9705,9,43,5242.0,193,9714,0.0009264978381717109,0.004426600782375952,141
10120,15,35,13827.0,320,10135,0.0014800197335964479,0.003453379378391712,270
10018,506,166,7780.0,855,10524,0.04808057772709996,0.015773470163435957,183
10076,7,10,3731.0,164,10083,0.0006942378260438362,0.0009917683229197659,147
9822,136,276,5301.0,554,9958,0.013657360915846555,0.027716408917453302,142
14843,184,119,2920.0,530,15027,0.012244626339256005,0.007919078991149265,227
18725,491,933,0.0,1657,19216,0.025551623646960866,0.04855328892589509,233
16687,217,235,0.0,928,16904,0.01283719829626124,0.013902035021296735,476
20032,207,34,3431.0,637,20239,0.01022777805227531,0.0016799248974751716,396
12343,193,401,9818.0,752,12536,0.015395660497766432,0.03198787492022974,158
21845,578,741,117.0,1762,22423,0.02577710386656558,0.033046425545199126,443
20508,179,90,9088.0,563,20687,0.00865277710639532,0.0043505583216512786,294
16513,179,13,1522.0,407,16692,0.010723699976036425,0.000778816199376947,215
11174,36,55,0.0,233,11210,0.0032114183764495987,0.004906333630686887,142
13643,191,302,14304.0,846,13834,0.013806563539106548,0.021830273239843864,353
13113,213,253,0.0,736,13326,0.015983791085096802,0.0189854419930962,270
13047,254,45,2218.0,507,13301,0.019096308548229458,0.0033832042703556124,208
17490,186,207,9140.0,714,17676,0.010522742701968771,0.011710794297352342,321
12012,246,151,3596.0,718,12258,0.020068526676456193,0.012318485886767825,321
14773,180,189,10670.0,671,14953,0.012037718183642078,0.012639604092824183,302
10857,193,230,4587.0,776,11050,0.01746606334841629,0.02081447963800905,353
14598,186,14,9241.0,514,14784,0.012581168831168832,0.000946969696969697,314
10203,188,203,7160.0,741,10391,0.018092580117409298,0.019536137041670676,350
13946,183,193,19088.0,785,14129,0.012952084365489419,0.013659848538466983,409
11202,187,193,6529.0,616,11389,0.01641935200632189,0.016946176134866976,236
13858,183,211,180.0,661,14041,0.013033259739334805,0.015027419699451606,267
11967,204,63,3321.0,459,12171,0.01676115356174513,0.0051762385999507025,192
12599,202,161,332.0,510,12801,0.015780017186157333,0.01257714241074916,147
28028,438,437,3378.0,1739,28466,0.015386777207897141,0.015351647579568608,864
13567,12,50,3156.0,323,13579,0.000883717504970911,0.003682156270712129,261
12573,16,36,5821.0,326,12589,0.0012709508300897609,0.002859639367701962,274
11981,48,22,144.0,263,12029,0.003990356638124532,0.0018289134591404107,193
14774,138,590,1788.0,1251,14912,0.009254291845493562,0.039565450643776826,523
13166,179,115,7673.0,499,13345,0.013413263394529787,0.008617459722742601,205
6584,31,28,5449.0,179,6615,0.004686318972033258,0.004232804232804233,120
19676,388,217,5107.0,1178,20064,0.01933811802232855,0.010815390749601276,573
11237,697,526,7488.0,1510,11934,0.0584045584045584,0.0440757499581029,287
9896,702,546,2318.0,1546,10598,0.0662389130024533,0.05151915455746367,298
16312,381,562,43564.0,1415,16693,0.022823938177679266,0.033666806445815614,472
14258,1023,1104,4205.0,2431,15281,0.06694588050520255,0.07224658072115699,304
22372,400,840,12175.0,2080,22772,0.01756543123133673,0.03688740558580713,840
24306,715,1222,10541.0,2501,25021,0.028575996163222893,0.048838975260780945,564
22640,627,552,17511.0,1612,23267,0.026948037993725017,0.023724588472944515,433
14040,560,377,6854.0,1262,14600,0.038356164383561646,0.02582191780821918,325
16200,414,517,0.0,1667,16614,0.024918743228602384,0.031118333935235342,736
14274,801,895,1051.0,2656,15075,0.05313432835820896,0.059369817578772806,960
14589,519,364,5211.0,1281,15108,0.03435266084193805,0.024093195657929573,398
12231,556,377,4843.0,1259,12787,0.04348166106201611,0.02948306874169078,326
38180,45,39,15299.0,736,38225,0.0011772400261608894,0.0010202746893394376,652
18848,1031,1561,3460.0,2971,19879,0.05186377584385533,0.07852507671412043,379
28859,29,164,0.0,596,28888,0.0010038770423705344,0.005677097756854057,403
16877,1159,1181,4381.0,2666,18036,0.06426036815258372,0.06548015080949213,326
25738,23,218,3375.0,679,25761,0.0008928224835992391,0.008462404409766701,438
19988,149,124,0.0,523,20137,0.007399314694343745,0.0061578189402592244,250
13131,18,31,0.0,210,13149,0.0013689253935660506,0.002357593733363754,161
23203,17,87,497.0,386,23220,0.0007321274763135229,0.0037467700258397934,282
15344,8,11,0.0,218,15352,0.0005211047420531526,0.0007165190203230849,199
19690,30,45,0.0,323,19720,0.0015212981744421906,0.002281947261663286,248
19391,14,122,0.0,363,19405,0.0007214635403246586,0.006287039422829168,227
17187,485,449,1814.0,1450,17672,0.027444545043005884,0.025407424173834313,516
19466,24,92,0.0,355,19490,0.0012314007183170856,0.0047203694202154955,239
21322,21,117,23.0,407,21343,0.0009839291571006887,0.005481891018132409,269
18695,25,155,0.0,445,18720,0.0013354700854700855,0.00827991452991453,265
19000,30,69,0.0,329,19030,0.0015764582238570678,0.003625853914871256,230
16480,25,212,0.0,446,16505,0.001514692517418964,0.012844592547712815,209
16408,36,93,0.0,310,16444,0.0021892483580637314,0.005655558258331307,181
16356,20,89,0.0,298,16376,0.0012212994626282364,0.005434782608695652,189
14692,38,49,0.0,256,14730,0.0025797691785471827,0.0033265444670739987,169
16875,25,306,0.0,547,16900,0.0014792899408284023,0.018106508875739644,216
15224,24,864,1110.0,1146,15248,0.0015739769150052466,0.05666316894018888,258
13078,30,69,0.0,252,13108,0.0022886786695148,0.00526396093988404,153
10981,18,87,0.0,232,10999,0.0016365124102191108,0.007909809982725703,127
23646,185,472,1569.0,1121,23831,0.007762997776006042,0.019806134866350553,464
14262,875,719,5361.0,2252,15137,0.05780537755169452,0.04749950452533527,658
16510,973,741,6511.0,2292,17483,0.055654063947835036,0.04238403020076646,578
12123,185,379,46.0,809,12308,0.015030874228144296,0.030792980175495612,245
17943,672,552,1807.0,1655,18615,0.036099919419822726,0.029653505237711524,431
18075,522,363,10688.0,1231,18597,0.02806904339409582,0.019519277302790773,346
12795,866,709,9585.0,1820,13661,0.06339213820364542,0.05189956811360808,245
18106,201,508,3681.0,1339,18307,0.010979406784290163,0.02774894848964877,630
19422,25,1594,0.0,1915,19447,0.0012855453283282768,0.08196637013421093,296
32797,621,404,4313.0,1755,33418,0.018582799688790473,0.01208929319528398,730
10818,29,33,2549.0,190,10847,0.0026735502904028765,0.0030423158476998247,128
12437,26,49,0.0,205,12463,0.0020861750782315653,0.003931637647436412,130
7530,202,353,4141.0,695,7732,0.02612519399896534,0.04565442317640973,140
11347,898,603,8203.0,1928,12245,0.07333605553287056,0.049244589628419766,427
34828,724,670,2994.0,2108,35552,0.020364536453645363,0.018845634563456344,714
29392,1076,1271,19961.0,2917,30468,0.035315741105422085,0.04171589864776159,570
15911,294,495,3380.0,1039,16205,0.01814254859611231,0.03054612773835236,250
33253,826,1610,8450.0,3329,34079,0.02423780040494146,0.0472431702808181,893
17517,441,629,0.0,1342,17958,0.024557300367524224,0.03502617217953002,272
15039,353,560,0.0,1112,15392,0.022933991683991684,0.036382536382536385,199
15204,355,551,3176.0,1132,15559,0.022816376373802943,0.03541358699145189,226
19934,239,393,0.0,943,20173,0.01184751896098746,0.019481485153422892,311
14433,694,566,6456.0,1604,15127,0.04587823097772195,0.03741653996165796,344
13096,698,593,2301.0,1621,13794,0.05060171088879223,0.0429897056691315,330
12730,718,547,2045.0,1624,13448,0.05339083878643665,0.04067519333729923,359
17400,1236,1255,89.0,2933,18636,0.06632324533161622,0.06734277742004723,442
15528,436,551,2283.0,1379,15964,0.027311450764219494,0.034515159107992986,392
12057,373,590,5960.0,1168,12430,0.03000804505229284,0.04746580852775543,205
34837,18,91,13408.0,182,34855,0.0005164251900731603,0.002610816238703199,73
11087,67,109,119.0,260,11154,0.006006813699121392,0.009772279003048234,84
14429,333,65,7610.0,464,14762,0.022557918981167862,0.00440319739872646,66
10796,173,53,10921.0,299,10969,0.015771720302671165,0.004831798705442611,73
18123,45,114,6445.0,239,18168,0.002476882430647292,0.006274768824306473,80
34903,342,132,0.0,594,35245,0.009703504043126684,0.0037452120868208256,120
29052,47,126,0.0,264,29099,0.0016151757792364,0.004330045706038008,91
13912,64,223,0.0,444,13976,0.0045792787635947334,0.0159559244419004,157
24792,55,200,7.0,485,24847,0.0022135469070712764,0.008049261480259187,230
47239,54,80,0.0,325,47293,0.001141818028037976,0.0016915822637599645,191
54888,170,141,0.0,657,55058,0.0030876530204511604,0.002560935740491845,346
22716,118,316,0.0,582,22834,0.0051677323289830955,0.013839011999649646,148
15722,17,54,11556.0,172,15739,0.0010801194485037168,0.003430967659952983,101
19175,72,302,0.0,594,19247,0.003740842728736946,0.015690757001091078,220
25300,21,20,0.0,83,25321,0.0008293511314719008,0.0007898582204494294,42
53133,144,134,0.0,508,53277,0.0027028548904780673,0.0025151566341948682,230
20850,37,101,2.0,304,20887,0.0017714367788576628,0.004835543639584431,166
23872,37,25,2168.0,101,23909,0.0015475344012714878,0.0010456313522104648,39
16025,6,12,13765.0,65,16031,0.0003742748424926705,0.000748549684985341,47
15348,17,91,0.0,216,15365,0.0011064106736088514,0.00592255125284738,108
20849,11,17,10284.0,76,20860,0.0005273250239693193,0.0008149568552253116,48
23347,56,407,0.0,573,23403,0.0023928556168012647,0.017390932786394905,110
37105,186,233,14.0,503,37291,0.004987798664557131,0.0062481563916226435,84
74631,200,216,0.0,616,74831,0.00267268912616429,0.0028865042562574335,200
20918,15,153,0.0,369,20933,0.0007165719199350308,0.007309033583337315,201
16606,14,52,2.0,132,16620,0.0008423586040914561,0.003128760529482551,66
30589,52,158,0.0,490,30641,0.0016970725498515061,0.005156489670702653,280
42769,193,116,355.0,1246,42962,0.004492342069736046,0.0027000605185978307,937
22724,70,299,0.0,583,22794,0.003070983592173379,0.013117487057997718,214
45691,277,381,517.0,1478,45968,0.0060259310824921685,0.008288374521406195,820
17001,27,239,11144.0,273,17028,0.0015856236786469344,0.014035705896171013,7
39622,20,48,0.0,158,39642,0.0005045154129458655,0.0012108369910700772,90
34872,206,367,2.0,974,35078,0.005872626717600775,0.010462398084269343,401
1064805,1141,1183,5054403.0,3924,1065946,0.0010704106962266381,0.001109812316946637,1600
1099021,2733,2473,1020225.0,7396,1101754,0.0024805900409710334,0.0022446026971538113,2190
1045095,645,457,6025632.0,2231,1045740,0.0006167881117677434,0.0004370111117486182,1129
40269,32,35,0.0,112,40301,0.0007940249621597479,0.0008684648023622243,45
1782127,1200,1068,10525104.0,3544,1783327,0.0006728995859985297,0.0005988806315386914,1276
1219759,533,643,3907945.0,2379,1220292,0.0004367807049460293,0.0005269230643157539,1203
28049,15,31,0.0,56,28064,0.0005344925883694413,0.001104618015963512,10
428307,1793,2266,232845.0,4886,430100,0.004168797953964194,0.005268542199488491,827
8833,2,25,8439.0,55,8835,0.00022637238256932655,0.0028296547821165816,28
184863,38,74,40409.0,210,184901,0.00020551538390814543,0.0004002141686632306,98
35546,8,13,0.0,32,35554,0.0002250098441806829,0.0003656409967936097,11
34271,10,10,0.0,35,34281,0.00029170677634841457,0.00029170677634841457,15
1759402,1015,761,12854199.0,3825,1760417,0.0005765679381646507,0.00043228394181605835,2049
26633,20,31,0.0,69,26653,0.0007503845720931978,0.0011630960867444566,18
16976,22,326,0.0,410,16998,0.001294269914107542,0.01917872690904812,62
42295,28,89,0.0,157,42323,0.0006615788105758098,0.0021028755050445385,40
15192,20,278,0.0,497,15212,0.0013147515119642387,0.01827504601630292,199
12537,25,97,10165.0,185,12562,0.0019901289603566313,0.007721700366183729,63
2485232,8095,7697,34101932.0,21024,2493327,0.0032466660008895745,0.0030870399269730766,5232
10144,28,72,6230.0,128,10172,0.0027526543452615023,0.007078254030672434,28
36404,59,66,0.0,173,36463,0.0016180786002248854,0.0018100540273702109,48
1448853,2735,1219,8645438.0,5679,1451588,0.0018841434346384787,0.0008397699622757972,1725
23248,740,620,4954.0,1856,23988,0.030848757712189426,0.025846256461564115,496
29935,442,32,0.0,541,30377,0.014550482272772162,0.0010534285808341838,67
20787,14,206,13047.0,251,20801,0.0006730445651651363,0.009903370030287005,31
130907,2252,1005,384019.0,3674,133159,0.016912112587207775,0.00754736818390045,417
