match,insertion,deletion,soft_clipping,NM,lengths,INS_readLength,DEL_readLength,NM_INS_DEL
59647,56,113,3137.0,342,59703,0.0009379763160980185,0.001892702209269216,173
1671684,3340,3420,13297795.0,9473,1675024,0.00199400127998166,0.0020417617896818195,2713
2847854,39540,39304,29602240.0,97121,2887394,0.01369400919999141,0.0136122745977861,18277
27037,191,194,22944.0,501,27228,0.00701483766710739,0.007125018363449391,116
42345,36,102,128348.0,299,42381,0.0008494372478233171,0.0024067388688327317,161
68302,48,96,0.0,413,68350,0.0007022677395757132,0.0014045354791514264,269
81231,597,445,67666.0,1546,81828,0.00729579117172606,0.005438236300532825,504
237887,182,127,413773.0,1075,238069,0.0007644842461639273,0.0005334587871583448,766
18931,79,116,26671.0,842,19010,0.004155707522356654,0.006102051551814834,647
13578,45,69,17557.0,597,13623,0.0033032371724289805,0.005064963664391103,483
13118,78,60,395.0,199,13196,0.005910882085480448,0.004546832373446499,61
7332,445,211,96.0,888,7777,0.05722000771505722,0.02713128455702713,232
62404,412,502,285.0,5970,62816,0.006558838512480896,0.007991594498217014,5056
40787,25,54,8804.0,2502,40812,0.0006125649318827796,0.0013231402528668039,2423
100796,3170,4093,15128.0,11589,103966,0.03049073735644345,0.0393686397476098,4326
19175,57,114,126.0,1436,19232,0.002963810316139767,0.005927620632279534,1265
44839,458,1087,13.0,4966,45297,0.010111044881559485,0.023997174205797292,3421
54552,101,111,182.0,4015,54653,0.0018480229813550948,0.0020309955537664904,3803
27494,43,108,0.0,1289,27537,0.0015615353887496821,0.003921995860115481,1138
43770,72,190,340.0,2539,43842,0.0016422608457643355,0.004333743898544774,2277
49901,31,71,0.0,1675,49932,0.0006208443483137066,0.001421933830008812,1573
18026,88,1496,23563.0,2172,18114,0.004858120790548747,0.08258805343932869,588
41649,48,46,0.0,981,41697,0.0011511619540974171,0.0011031968726766914,887
27763,9,1621,0.0,2141,27772,0.00032406740602045227,0.05836814057323923,511
34245,1496,2726,102.0,5214,35741,0.041856691194986154,0.07627094932990124,992
18957,27,328,144.0,732,18984,0.0014222503160556258,0.017277707543194267,377
13846,18,489,0.0,774,13864,0.001298326601269475,0.03527120600115407,267
38011,1038,1467,0.0,3648,39049,0.02658198673461548,0.0375681835642398,1143
23356,21,76,12.0,576,23377,0.0008983188604183599,0.003251058732942636,479
103591,5582,7165,97.0,19316,109173,0.05112985811510172,0.06562978025702326,6569
6626,6,69,0.0,159,6632,0.0009047044632086852,0.01040410132689988,84
54651,1849,1747,0.0,8005,56500,0.03272566371681416,0.030920353982300884,4409
28645,722,1884,0.0,3460,29367,0.024585419007729765,0.06415364184288487,854
35937,53,99,18.0,1644,35990,0.0014726312864684634,0.0027507641011392052,1492
37972,1183,1324,0.0,5113,39155,0.030213255012131273,0.033814327672072535,2606
7806,8,813,17214.0,991,7814,0.0010238034297414896,0.10404402354747888,170
10575,57,56,49.0,961,10632,0.00536117381489842,0.005267118133935289,848
27941,53,388,0.0,1246,27994,0.0018932628420375796,0.013860112881331713,805
68762,184,36,219982.0,532,68946,0.00266875525773794,0.0005221477678182926,312
8966,472,554,660.0,1519,9438,0.05001059546514092,0.05869887688069506,493
12587,87,446,34595.0,1178,12674,0.006864446899163642,0.035190153069275684,645
10993,64,265,32746.0,924,11057,0.005788188477887311,0.02396671791625215,595
8771,53,202,22713.0,696,8824,0.00600634632819583,0.022892112420670897,441
14520,350,417,103729.0,1568,14870,0.023537323470073975,0.02804303967720242,801
19834,619,555,71052.0,2252,20453,0.030264508874003813,0.027135383562313597,1078
19436,689,949,64796.0,2712,20125,0.0342360248447205,0.04715527950310559,1074
14570,225,355,50936.0,1363,14795,0.015207840486650895,0.023994592767826967,783
12682,181,397,25117.0,1303,12863,0.01407136748814429,0.030863717639741894,725
12610,73,307,24306.0,1058,12683,0.005755736024599858,0.024205629582906254,678
12468,311,449,15365.0,1510,12779,0.02433680256671101,0.035135769622036156,750
15647,294,418,12872.0,1571,15941,0.01844300859419108,0.026221692491060787,859
19599,208,638,15654.0,1905,19807,0.010501337910839603,0.032210834553440704,1059
15567,84,400,19622.0,1324,15651,0.005367069196856431,0.025557472365983006,840
17200,344,580,149895.0,2030,17544,0.0196078431372549,0.03305973552211582,1106
18632,595,549,39528.0,2201,19227,0.03094606542882405,0.028553596504914965,1057
18304,122,530,18805.0,1614,18426,0.006621078910235537,0.02876370346249864,962
18922,120,503,97958.0,1649,19042,0.006301859048419283,0.026415292511290833,1026
17016,318,450,65065.0,1709,17334,0.018345448251990307,0.02596053997923157,941
13780,87,381,83824.0,1234,13867,0.0062738876469315644,0.0274753010744934,766
17505,815,1037,42154.0,2868,18320,0.04448689956331878,0.05660480349344978,1016
16544,192,473,53986.0,1571,16736,0.011472275334608031,0.028262428298279157,906
15452,117,486,65526.0,1446,15569,0.007514933521741923,0.03121587770569722,843
13099,222,412,39676.0,1324,13321,0.016665415509346145,0.030928608963291044,690
12872,277,351,34706.0,1338,13149,0.021066240778766447,0.026694045174537988,710
12823,294,400,49286.0,1363,13117,0.022413661660440648,0.030494777769307008,669
14648,276,401,13445.0,1486,14924,0.018493701420530688,0.02686947199142321,809
15232,517,479,191022.0,1878,15749,0.03282748110991174,0.03041462950028573,882
12861,65,301,25743.0,1066,12926,0.005028624477796689,0.0232863995048739,700
13428,63,475,69353.0,1326,13491,0.004669779853235491,0.03520865762360092,788
12071,427,306,3254.0,1418,12498,0.03416546647463594,0.024483917426788286,685
12352,187,311,27395.0,1213,12539,0.014913469973682111,0.02480261583858362,715
12853,71,582,46846.0,1310,12924,0.005493655215103683,0.04503249767873723,657
28881,1213,1520,100091.0,4769,30094,0.04030703794776368,0.05050840699142686,2036
16574,621,626,82340.0,2288,17195,0.03611514975283513,0.03640593195696423,1041
11863,92,332,58300.0,1042,11955,0.0076955248849853615,0.02777080719364283,618
11833,357,362,51580.0,1417,12190,0.029286300246103365,0.029696472518457754,698
14371,677,581,28017.0,2155,15048,0.04498936735778841,0.03860978203083466,897
10393,68,293,42536.0,903,10461,0.006500334576044355,0.028008794570308766,542
10925,210,377,32462.0,1235,11135,0.018859452177817693,0.03385720700493938,648
8862,53,261,23292.0,817,8915,0.005945036455412227,0.02927650028042625,503
23112,797,991,119190.0,3347,23909,0.033334727508469615,0.04144882680162282,1559
10758,348,388,37965.0,1363,11106,0.031334413830361965,0.034936070592472536,627
17313,572,1015,193358.0,2881,17885,0.031982107911657814,0.05675146771037182,1294
13436,330,597,41578.0,1804,13766,0.02397210518669185,0.04336771756501526,877
61018,413,141,43708.0,870,61431,0.006722990021324739,0.0022952580944474287,316
48055,284,186,18649.0,632,48339,0.005875173255549349,0.0038478247377893627,162
1143090,491,499,2450981.0,2372,1143581,0.0004293530585065684,0.00043634862768793817,1382
28342,26,66,0.0,98,28368,0.0009165256627185561,0.002326565143824027,6
35556,17,44,0.0,80,35573,0.0004778905349562871,0.0012368931492986253,19
240085,125,211,0.0,628,240210,0.0005203780025810749,0.0008783980683568544,292
12448,34,190,0.0,259,12482,0.002723922448325589,0.015221919564172409,35
128169,9,21,71124.0,90,128178,7.021485746383936e-05,0.00016383466741562514,60
32982,6,12,35337.0,32,32988,0.00018188432157148054,0.0003637686431429611,14
121476,85,205,0.0,507,121561,0.0006992374198961838,0.001686396130337855,217
52935,47,35,5835.0,144,52982,0.0008870937299460194,0.0006606017137895889,62
22533,32,47,2057.0,100,22565,0.0014181254154664303,0.0020828717039663197,21
322692,520,205,335268.0,1089,323212,0.001608851156516466,0.0006342586290112991,364
37010,2,7,0.0,10,37012,5.4036528693396736e-05,0.00018912785042688859,1
51990,36,98,0.0,223,52026,0.0006919617114519663,0.0018836735478414638,89
1032361,557,638,853030.0,2310,1032918,0.0005392490013728099,0.0006176676173713692,1115
2362786,34030,33632,27151603.0,82912,2396816,0.01419800268356019,0.01403194905240953,15250
22389,114,126,0.0,266,22503,0.005065991201173177,0.005599253432875617,26
1449423,15041,15569,5977042.0,39179,1464464,0.010270651924526654,0.010631193392258192,8569
19424,61,44,0.0,129,19485,0.00313061329227611,0.002258147292789325,24
154464,198,203,300393.0,920,154662,0.0012802110408503705,0.001312539602488006,519
150262,58,82,0.0,344,150320,0.00038584353379457156,0.000545502927088877,204
72669,26,40,0.0,81,72695,0.0003576587110530298,0.000550244170850815,15
2198747,963,888,34844156.0,3352,2199710,0.0004377849807474622,0.00040368957726245733,1501
2964,9,23,0.0,45,2973,0.0030272452068617556,0.007736293306424487,13
25117,155,221,6103.0,472,25272,0.006133270022158911,0.00874485596707819,96
897984,624,360,3078772.0,1657,898608,0.0006944073500347204,0.00040061962502003096,673
6972,197,10,0.0,219,7169,0.027479425303389593,0.0013948946854512485,12
19107,134,109,243.0,291,19241,0.006964294995062626,0.005664986227327062,48
554866,8721,8406,4716134.0,20868,563587,0.015474097166897037,0.014915177248588062,3741
9045,415,241,80550.0,1532,9460,0.04386892177589852,0.02547568710359408,876
9045,412,241,113013.0,1556,9457,0.04356561277360685,0.025483768636988473,903
9426,417,307,258632.0,1643,9843,0.04236513258153002,0.031189677943716347,919
5610,14,69,86677.0,718,5624,0.0024893314366998577,0.012268847795163585,635
2197,7,81,39131.0,282,2204,0.003176043557168784,0.0367513611615245,194
2196,7,82,72183.0,285,2203,0.0031774852473899226,0.03722197004085338,196
2190,7,85,20120.0,285,2197,0.0031861629494765588,0.03868912152935822,193
2162,2,78,28131.0,286,2164,0.0009242144177449168,0.036044362292051754,206
2534,8,87,152608.0,321,2542,0.003147128245476003,0.034225019669551535,226
2163,2,76,80750.0,270,2165,0.0009237875288683603,0.03510392609699769,192
2161,2,78,36425.0,279,2163,0.0009246417013407304,0.036061026352288486,199
2161,4,78,53132.0,279,2165,0.0018475750577367205,0.03602771362586605,197
2157,4,82,49752.0,257,2161,0.0018509949097639982,0.03794539565016196,171
2157,2,79,21705.0,272,2159,0.0009263547938860583,0.036591014358499305,191
2163,2,76,19916.0,281,2165,0.0009237875288683603,0.03510392609699769,203
2363,3,84,31545.0,299,2366,0.001267962806424345,0.03550295857988166,212
2490,6,79,29711.0,332,2496,0.002403846153846154,0.031650641025641024,247
2496,6,80,28183.0,333,2502,0.002398081534772182,0.0319744204636291,247
2163,2,76,32519.0,272,2165,0.0009237875288683603,0.03510392609699769,194
2160,2,79,27851.0,275,2162,0.0009250693802035153,0.03654024051803885,194
2163,2,76,28365.0,270,2165,0.0009237875288683603,0.03510392609699769,192
2159,4,80,21557.0,263,2163,0.0018492834026814608,0.03698566805362922,179
2541,7,80,101503.0,342,2548,0.0027472527472527475,0.03139717425431711,255
2486,5,83,55309.0,297,2491,0.002007226013649137,0.03331995182657567,209
2490,6,86,39004.0,332,2496,0.002403846153846154,0.03445512820512821,240
2542,5,79,55790.0,332,2547,0.0019630938358853552,0.031016882606988615,248
2129,4,110,27200.0,295,2133,0.001875293014533521,0.051570557899671826,181
2160,2,79,49498.0,258,2162,0.0009250693802035153,0.03654024051803885,177
2468,8,84,66222.0,340,2476,0.0032310177705977385,0.033925686591276254,248
2162,2,77,29369.0,257,2164,0.0009242144177449168,0.0355822550831793,178
2163,2,76,31871.0,274,2165,0.0009237875288683603,0.03510392609699769,196
2156,2,83,15404.0,267,2158,0.0009267840593141798,0.038461538461538464,182
2163,2,76,13749.0,274,2165,0.0009237875288683603,0.03510392609699769,196
2536,7,85,25062.0,339,2543,0.0027526543452615023,0.03342508847817539,247
2158,6,81,10198.0,283,2164,0.0027726432532347504,0.03743068391866913,196
2092,5,147,11413.0,350,2097,0.002384358607534573,0.07010014306151645,198
