match,insertion,deletion,soft_clipping,NM,lengths,INS_readLength,DEL_readLength,NM_INS_DEL
66386,814,811,25902.0,2198,67200,0.012113095238095239,0.012068452380952381,573
65503,343,271,0.0,680,65846,0.005209124320383926,0.004115663821644443,66
130821,709,708,4780.0,1721,131530,0.005390405230745837,0.0053828024024937275,304
71670,166,56,0.0,282,71836,0.00231081908792249,0.0007795534272509605,60
24396,109,30,0.0,161,24505,0.004448071822077127,0.001224239951030402,22
50975,215,82,0.0,381,51190,0.004200039070130885,0.001601875366282477,84
49872,281,194,19824.0,685,50153,0.00560285526289554,0.003868163419934999,210
13418,8,52,0.0,76,13426,0.0005958587814687919,0.0038730820795471474,16
182168,396,375,774530.0,953,182564,0.002169102342192327,0.002054074187682128,182
339764,290,388,897384.0,1029,340054,0.0008528057308545113,0.0011409952536950013,351
34054,33,28,6406.0,112,34087,0.0009681110100624872,0.0008214275236893831,51
602578,839,476,4047642.0,1991,603417,0.0013904149203618724,0.0007888408844961279,676
27132,128,260,3754.0,443,27260,0.004695524578136464,0.009537784299339692,55
26467,76,185,35107.0,341,26543,0.002863278453829635,0.0069698225520852955,80
10325,55,152,7461.0,241,10380,0.0052986512524084775,0.01464354527938343,34
721493,1285,769,963252.0,3123,722778,0.0017778626355533789,0.001063950479953734,1069
38684,336,53,18482.0,492,39020,0.008610968733982573,0.0013582778062532035,103
21605,20,81,9978.0,141,21625,0.0009248554913294797,0.003745664739884393,40
1680211,1742,922,7345684.0,3628,1681953,0.0010357007597715275,0.0005481722735415317,964
870916,828,496,3722410.0,2205,871744,0.0009498201306805667,0.0005689743777989868,881
15248,47,31,0.0,96,15295,0.003072899640405361,0.002026806145799281,18
290051,78,146,0.0,412,290129,0.0002688459271565407,0.0005032244277545506,188
344829,61,76,1453778.0,304,344890,0.00017686798689437212,0.00022036011481921773,167
62710,47,222,407778.0,1023,62757,0.000748920439154198,0.0035374539891964243,754
28101,555,60,3.0,728,28656,0.019367671691792293,0.0020938023450586263,113
10717,358,44,0.0,499,11075,0.03232505643340858,0.003972911963882619,97
20879,201,264,0.0,592,21080,0.009535104364326375,0.012523719165085389,127
9948,69,34,12710.0,552,10017,0.006888289907157832,0.003394229809324149,449
25019,712,36,85486.0,1351,25731,0.027670902802067545,0.0013990905911157748,603
17890,353,36,48095.0,809,18243,0.019349887628131338,0.001973359644795264,420
6519,25,32,15758.0,239,6544,0.003820293398533007,0.004889975550122249,182
1742473,989,950,7475139.0,3398,1743462,0.0005672621485297644,0.0005448928625917858,1459
28042,87,46,3.0,196,28129,0.003092893455153045,0.001635322976287817,63
44210,221,138,109.0,1240,44431,0.004974004636402512,0.0031059395467128805,881
448300,150,82,515095.0,317,448450,0.0003344854498829301,0.00018285204593600178,85
15804,66,153,0.0,274,15870,0.004158790170132325,0.009640831758034027,55
1514171,729,732,9125985.0,2561,1514900,0.00048121988250049506,0.000483200211235065,1100
1034615,961,653,1152324.0,2413,1035576,0.0009279859710924162,0.0006305669501803827,799
46727,238,160,64299.0,888,46965,0.005067603534547003,0.003406792292132439,490
355013,348,776,5644.0,1593,355361,0.0009792858529776762,0.0021836948905479218,469
710424,285,133,1817176.0,762,710709,0.0004010080074967392,0.00018713707016514494,344
28693,506,133,0.0,770,29199,0.017329360594540908,0.0045549505120038355,131
795587,906,1278,2369007.0,3555,796493,0.0011374864562525974,0.0016045338753761804,1371
778460,397,548,1677769.0,1543,778857,0.0005097212967207074,0.0007035951400578027,598
