match,insertion,deletion,soft_clipping,NM,lengths,INS_readLength,DEL_readLength,NM_INS_DEL
21706,219,223,9938.0,590,21925,0.009988597491448118,0.010171037628278222,148
122949,203,396,0.0,857,123152,0.001648369494608289,0.0032155385215018838,258
125134,465,325,5290.0,1118,125599,0.0037022587759456683,0.0025876002197469726,328
18901,502,191,3356.0,1086,19403,0.025872287790547854,0.00984383858166263,393
287291,1826,2747,1444316.0,5697,289117,0.00631578219198456,0.009501343746649281,1124
51750,29,16,0.0,74,51779,0.0005600726163116322,0.0003090055814133143,29
767785,473,592,3885574.0,2990,768258,0.0006156785871412988,0.0007705744684728307,1925
30064,19,98,0.0,377,30083,0.0006315859455506433,0.0032576538244191073,260
30970,47,76,0.0,424,31017,0.0015152980623529032,0.00245026920720895,301
91423,44,185,0.0,525,91467,0.0004810478095925306,0.002022587381241322,296
18168,59,156,0.0,295,18227,0.0032369561639326275,0.008558731552093048,80
25148,93,144,0.0,355,25241,0.003684481597401054,0.005705003763717761,118
23846,36,445,0.0,924,23882,0.0015074114395779248,0.018633280294782683,443
19073,39,54,3.0,182,19112,0.002040602762662202,0.002825449979070741,89
44271,56,36,0.0,142,44327,0.0012633383716470774,0.0008121460960588355,50
38028,103,88,0.0,618,38131,0.0027012142351367655,0.0023078335212818966,427
20287,323,370,0.0,1405,20610,0.015672003881610868,0.017952450266860747,712
21974,40,86,4725.0,208,22014,0.0018170255292086854,0.003906604887798673,82
21389,22,141,459.0,391,21411,0.0010275092242305356,0.006585400028022979,228
19428,159,43,8585.0,308,19587,0.008117629039669168,0.0021953336396589576,106
15871,33,62,9746.0,200,15904,0.002074949698189135,0.003898390342052314,105
26181,54,56,3494.0,307,26235,0.002058319039451115,0.0021345530779493045,197
19860,44,156,0.0,409,19904,0.0022106109324758843,0.007837620578778135,209
26752,15,34,0.0,104,26767,0.0005603915268801136,0.0012702207942615908,55
17367,18,23,0.0,69,17385,0.0010353753235547887,0.0013229795800977855,28
22449,50,55,0.0,140,22499,0.002222320992044091,0.0024445530912485,35
28796,60,35,0.0,153,28856,0.0020792902689215414,0.001212919323537566,58
27655,26,31,0.0,293,27681,0.00093927242512915,0.0011199017376539865,236
24469,68,65,0.0,301,24537,0.002771324937848963,0.0026490606023556263,168
21677,49,67,0.0,289,21726,0.0022553622387922307,0.0030838626530424375,173
34836,77,245,0.0,633,34913,0.0022054821986079685,0.007017443359207172,311
34058,50,363,0.0,732,34108,0.001465931746217896,0.010642664477541926,319
30902,26,65,0.0,387,30928,0.0008406621831350233,0.0021016554578375582,296
26148,16,16,0.0,235,26164,0.0006115272894052897,0.0006115272894052897,203
24309,45,83,0.0,337,24354,0.0018477457501847746,0.00340806438367414,209
20770,35,35,0.0,221,20805,0.0016822879115597211,0.0016822879115597211,151
23409,7,62,0.0,256,23416,0.00029894089511445167,0.0026477622138708573,187
24834,38,29,3.0,300,24872,0.0015278224509488582,0.0011659697651978129,233
20764,50,51,0.0,308,20814,0.0024022292687614108,0.002450273854136639,207
16431,50,43,0.0,244,16481,0.003033796492931254,0.0026090649839208787,151
38858,180,155,0.0,453,39038,0.004610891951431938,0.0039704902915108356,118
176749,129,157,13.0,722,176878,0.0007293162518798268,0.0008876174538382387,436
21246,127,288,0.0,840,21373,0.0059420764515978105,0.013474945024095821,425
17423,23,48,0.0,145,17446,0.0013183537773701708,0.0027513470136420956,74
18078,47,43,0.0,243,18125,0.002593103448275862,0.0023724137931034482,153
61205,26,110,3391.0,481,61231,0.0004246215152455456,0.001796475641423462,345
18516,14,60,0.0,196,18530,0.0007555315704263357,0.0032379924446842958,122
12271,43,146,0.0,274,12314,0.003491960370310216,0.011856423582913757,85
15492,32,35,0.0,189,15524,0.002061324400927596,0.002254573563514558,122
35345,233,321,7052.0,2224,35578,0.0065489909494631515,0.009022429591320479,1670
19677,16,75,16604.0,293,19693,0.0008124714365510588,0.0038084598588330877,202
17371,32,102,8938.0,240,17403,0.0018387634315922541,0.00586105843820031,106
11711,93,154,0.0,353,11804,0.007878685191460523,0.013046424940698069,106
14698,24,52,0.0,128,14722,0.0016302132862382828,0.0035321287868496126,52
15187,42,24,26553.0,113,15229,0.002757896119246175,0.001575940639569243,47
21357,26,188,0.0,580,21383,0.0012159191881401113,0.00879203105270542,366
27393,54,208,0.0,561,27447,0.0019674281342223193,0.007578241702189675,299
33314,449,617,0.0,1694,33763,0.01329858128720789,0.018274442436987233,628
18826,49,76,0.0,181,18875,0.002596026490066225,0.004026490066225166,56
26080,84,337,0.0,753,26164,0.003210518269377771,0.012880293533098915,332
22697,12,12,7057.0,62,22709,0.0005284248535822802,0.0005284248535822802,38
42434,21,28,0.0,94,42455,0.000494641384995878,0.0006595218466611707,45
168351,214,279,44033.0,1047,168565,0.0012695399400824607,0.001655147865808442,554
26750,97,588,0.0,1082,26847,0.003613066636868179,0.021901888479159682,397
41983,90,112,17847.0,357,42073,0.0021391391153471346,0.0026620397879875456,155
49340,87,92,953.0,380,49427,0.0017601715661480566,0.0018613308515588647,201
12064,26,122,0.0,219,12090,0.002150537634408602,0.010090984284532672,71
19522,182,333,13976.0,1000,19704,0.009236703207470564,0.01690012180267966,485
30402,172,339,0.0,1972,30574,0.0056256950349970565,0.01108785242362792,1461
29472,229,336,0.0,2031,29701,0.007710178108481196,0.011312750412444025,1466
30894,36,52,0.0,190,30930,0.0011639185257032007,0.0016812156482379566,102
41050,69,303,0.0,819,41119,0.0016780563729662686,0.007368856246504049,447
14171,47,164,0.0,390,14218,0.0033056688704459136,0.011534674356449571,179
2266873,2435,2034,9667333.0,9171,2269308,0.0010730143285970876,0.0008963084781792511,4702
31661,21,31,0.0,87,31682,0.0006628369421122404,0.0009784735812133072,35
178263,89,131,100485.0,376,178352,0.0004990131874046829,0.0007345025567417243,156
858429,806,671,1349169.0,2439,859235,0.0009380437249413723,0.0007809272201434997,962
29367,35,44,0.0,123,29402,0.0011903952112101218,0.0014964968369498674,44
1900639,1156,875,18820413.0,3496,1901795,0.00060784679736775,0.00046009165025673115,1465
18633,23,86,0.0,124,18656,0.0012328473413379074,0.0046097770154373925,15
25614,44,40,621.0,147,25658,0.0017148647595291917,0.001558967963208356,63
14038,23,17,3424.0,193,14061,0.0016357300334257877,0.0012090178507929736,153
17850,21,20,96.0,238,17871,0.0011750881316098707,0.0011191315539141626,197
10998,8,7,5207.0,116,11006,0.0007268762493185535,0.0006360167181537343,101
10227,1,6,10532.0,109,10228,9.777082518576456e-05,0.0005866249511145874,102
13652,34,38,9608.0,622,13686,0.0024842905158556187,0.002776559988309221,550
16010,380,161,2656.0,782,16390,0.023184868822452714,0.009823062843197072,241
12567,207,172,2372.0,544,12774,0.016204790981681542,0.013464850477532488,165
13990,194,55,2775.0,534,14184,0.013677382966723068,0.003877608573040045,285
9431,2,6,11912.0,124,9433,0.000212021626205873,0.000636064878617619,116
9426,8,11,2412.0,135,9434,0.0008479966080135679,0.001165995336018656,116
8352,2,6,4326.0,52,8354,0.00023940627244433804,0.0007182188173330142,44
12852,196,47,14466.0,417,13048,0.015021459227467811,0.0036020846106683017,174
12045,29,228,4097.0,469,12074,0.0024018552261056815,0.018883551432830877,212
12429,42,247,3615.0,446,12471,0.003367813326918451,0.019805949803544224,157
12945,9,7,7444.0,150,12954,0.0006947660954145438,0.0005403736297668674,134
14023,200,698,12025.0,1191,14223,0.014061730999085987,0.0490754411868101,293
10399,39,125,4656.0,249,10438,0.003736347959379191,0.01197547422877946,85
11814,185,82,6519.0,454,11999,0.015417951495957996,0.006833902825235437,187
14859,674,720,8456.0,1701,15533,0.04339148908774866,0.046352926028455546,307
12546,37,342,2786.0,730,12583,0.0029404752443773345,0.02717952793451482,351
12768,205,117,319.0,510,12973,0.015802050412394974,0.009018731210976644,188
14377,215,372,2185.0,949,14592,0.014734100877192983,0.02549342105263158,362
14109,6,138,10401.0,267,14115,0.0004250797024442083,0.00977683315621679,123
17053,421,403,49428.0,1246,17474,0.0240929380794323,0.023062836213803364,422
12992,6,11,8981.0,109,12998,0.0004616094783812894,0.0008462840436990306,92
16067,10,14,13834.0,137,16077,0.0006220065932698887,0.0008708092305778441,113
8919,20,36,4702.0,128,8939,0.0022373867322966774,0.00402729611813402,72
9423,8,9,15610.0,144,9431,0.0008482663556356696,0.0009542996500901282,127
10929,8,7,14195.0,74,10937,0.0007314620096918717,0.0006400292584803877,59
25663,383,477,3849.0,1563,26046,0.014704753129079321,0.018313752591568762,703
12002,7,12,29847.0,107,12009,0.000582896161212424,0.0009992505620784412,88
17762,33,196,6268.0,418,17795,0.0018544534981736443,0.011014329867940433,189
14780,31,254,446.0,511,14811,0.002093038957531564,0.017149415974613464,226
16207,31,208,19562.0,530,16238,0.0019091021061707107,0.01280945929301638,291
16058,24,188,10125.0,479,16082,0.001492351697550056,0.011690088297475438,267
12197,36,228,434.0,427,12233,0.0029428594784599036,0.018638110030246055,163
9040,12,10,2988.0,94,9052,0.0013256738842244808,0.001104728236853734,72
13893,33,250,0.0,443,13926,0.002369668246445498,0.017952032170041647,160
12326,58,271,17376.0,496,12384,0.004683462532299742,0.021883074935400516,167
10748,30,206,3780.0,457,10778,0.0027834477639636294,0.019113007979216924,221
11513,70,371,2693.0,603,11583,0.00604333937667271,0.032029698696365363,162
9769,199,86,5013.0,468,9968,0.019963884430176566,0.00862760834670947,183
17437,51,327,5679.0,562,17488,0.002916285452881976,0.018698536139066788,184
11906,6,53,14305.0,193,11912,0.0005036937541974479,0.004449294828744123,134
13113,195,44,0.0,393,13308,0.014652840396753831,0.0033062819356777877,154
13704,345,134,262.0,721,14049,0.024556907964979714,0.009538045412484875,242
11335,30,297,2714.0,558,11365,0.0026396832380114386,0.02613286405631324,231
11196,36,259,1709.0,527,11232,0.003205128205128205,0.02305911680911681,232
10239,12,42,24805.0,231,10251,0.001170617500731636,0.004097161252560726,177
11460,9,161,14863.0,332,11469,0.0007847240387130526,0.01403784113697794,162
8532,88,115,6309.0,248,8620,0.010208816705336427,0.01334106728538283,45
13317,11,9,11941.0,209,13328,0.0008253301320528211,0.0006752701080432173,189
13687,189,24,12388.0,417,13876,0.013620639953877198,0.0017296050735082155,204
12398,374,434,6157.0,1315,12772,0.029282806138427812,0.03398058252427184,507
12588,33,753,5544.0,1010,12621,0.002614689802709769,0.05966246731637746,224
16672,15,16,3701.0,390,16687,0.0008989033379277282,0.00095883022712291,359
14460,222,222,16029.0,947,14682,0.015120555782590927,0.015120555782590927,503
19236,223,58,4870.0,628,19459,0.011459992805385682,0.0029806259314456036,347
13334,11,15,9580.0,175,13345,0.0008242787560884227,0.0011240164855751218,149
10744,3,6,15189.0,192,10747,0.0002791476691169629,0.0005582953382339258,183
13952,6,7,11117.0,153,13958,0.0004298610116062473,0.0005015045135406219,140
14590,257,293,2869.0,1051,14847,0.017309894254731596,0.019734626523876878,501
17828,44,270,53223.0,637,17872,0.0024619516562220233,0.015107430617726052,323
10434,26,16,9321.0,118,10460,0.00248565965583174,0.0015296367112810707,76
12005,4,12,14620.0,74,12009,0.0003330835206928137,0.0009992505620784412,58
12007,4,10,6409.0,71,12011,0.000333028057613854,0.000832570144034635,57
17353,33,133,107.0,413,17386,0.001898078914068791,0.007649833199125733,247
13502,75,47,3238.0,356,13577,0.005524048022390808,0.0034617367606982396,234
11810,32,47,5213.0,426,11842,0.0027022462421888195,0.003968924168214829,347
16347,35,304,0.0,766,16382,0.002136491270907093,0.01855695275302161,427
13272,54,52,0.0,240,13326,0.00405222872579919,0.0039021461803992194,134
16853,45,179,5496.0,364,16898,0.002663037045804237,0.010592969582199076,140
14315,56,144,1439.0,332,14371,0.003896736483195324,0.010020179528216547,132
13318,26,160,2089.0,374,13344,0.0019484412470023981,0.011990407673860911,188
12120,36,55,0.0,209,12156,0.0029615004935834156,0.0045245146429746625,118
19587,28,43,11137.0,391,19615,0.0014274789701758858,0.0021921998470558245,320
17598,19,31,36149.0,495,17617,0.0010785037179996595,0.0017596639609468126,445
10501,28,49,1910.0,230,10529,0.0026593218729224046,0.004653813277614208,153
20560,212,225,0.0,838,20772,0.010206046601193916,0.010831889081455806,401
19373,102,445,0.0,734,19475,0.0052374839537869065,0.022849807445442877,187
25098,55,56,0.0,349,25153,0.002186617898461416,0.002226374587524351,238
20257,208,482,0.0,856,20465,0.010163694111898363,0.023552406547764478,166
16185,389,138,0.0,760,16574,0.023470495957523832,0.00832629419572825,233
19253,101,139,3.0,385,19354,0.005218559470910406,0.007181977885708381,145
13978,35,109,0.0,259,14013,0.0024976807250410332,0.007778491400842075,115
17958,17,30,0.0,354,17975,0.0009457579972183589,0.0016689847009735744,307
6315336,3225,2908,33428473.0,11023,6318561,0.0005104010232709631,0.00046023137230138316,4890
23870,26,38,0.0,88,23896,0.001088048208905256,0.0015902243053230666,24
30930,25,42,0.0,131,30955,0.0008076239702794379,0.0013568082700694557,64
19159,1,19,10252.0,100,19160,5.2192066805845514e-05,0.0009916492693110648,80
33369,19,86,541.0,192,33388,0.0005690667305618785,0.0025757757278063974,87
26569,147,162,0.0,390,26716,0.005502320706692618,0.006063782003293906,81
45663,11,20,4890.0,143,45674,0.0002408372378158252,0.000437885886937864,112
11943,12,248,0.0,291,11955,0.0010037641154328732,0.020744458385612716,31
35672,76,249,2.0,447,35748,0.002125993062548954,0.0069654246391406514,122
22922,9,67,0.0,140,22931,0.00039248179320570405,0.002921808904975797,64
25504,10,67,14946.0,157,25514,0.0003919416790781532,0.002626009249823626,80
38047,54,40,0.0,186,38101,0.0014172856355476233,0.001049841211516758,92
19532,5,7,18654.0,58,19537,0.00025592465578133796,0.00035829451809387314,46
19937,11,57,0.0,118,19948,0.0005514337276919992,0.0028574293162221777,50
21858,20,215,2.0,294,21878,0.0009141603437242893,0.00982722369503611,59
35752,10,310,0.0,415,35762,0.00027962641910407696,0.008668418992226385,95
27816,20,20,0.0,110,27836,0.0007184940364994971,0.0007184940364994971,70
13333,26,99,0.0,163,13359,0.0019462534620854855,0.007410734336402425,38
22378,22,184,0.0,269,22400,0.0009821428571428572,0.008214285714285714,63
20174,21,253,3691.0,348,20195,0.0010398613518197574,0.0125278534290666,74
2965724,3942,4417,6588261.0,11396,2969666,0.0013274220063805155,0.0014873726540291063,3037
35315,44,279,0.0,374,35359,0.0012443790831188665,0.007890494640685539,51
3611499,1498,1449,15193916.0,5275,3612997,0.0004146142385393622,0.00040105209054975687,2328
6868,6,19,5422.0,34,6874,0.0008728542333430317,0.002764038405586267,9
2051626,1271,967,20745847.0,4119,2052897,0.0006191250705710028,0.000471041654793202,1881
773095,1588,1229,3475503.0,3939,774683,0.002049870721314396,0.001586455363032363,1122
211932,384,255,147567.0,927,212316,0.0018086248798960041,0.0012010399593059401,288
375754,254,530,2219181.0,1233,376008,0.0006755175421799536,0.0014095444777770685,449
252105,568,127,714806.0,975,252673,0.002247964760777764,0.0005026259236246058,280
