match,insertion,deletion,soft_clipping,NM,lengths,INS_readLength,DEL_readLength,NM_INS_DEL
20345,61,216,0.0,480,20406,0.0029893168675879643,0.010585122022934431,203
29526,15,69,0.0,148,29541,0.0005077688636132832,0.0023357367726211027,64
268758,419,226,194159.0,995,269177,0.0015565965888616042,0.0008395962507940872,350
138608,1231,541,81326.0,2051,139839,0.008802980570513232,0.003868734759258862,279
213538,172,1153,281661.0,1509,213710,0.0008048289738430583,0.005395161667680502,184
334105,430,625,946481.0,1714,334535,0.0012853662546519797,0.0018682649050174123,659
17524,16,25,6768.0,76,17540,0.0009122006841505131,0.0014253135689851768,35
1711056,1001,787,14342368.0,3457,1712057,0.0005846767952235235,0.00045968095688402895,1669
2004875,1025,763,16620533.0,2730,2005900,0.0005109925719128571,0.0003803778852385463,942
10921,4,17,9811.0,65,10925,0.00036613272311212814,0.0015560640732265446,44
27598,70,74,0.0,263,27668,0.0025299985542865406,0.0026745699002457715,119
24302,95,62,0.0,279,24397,0.003893921383776694,0.0025412960609911056,122
72265,70,120,0.0,217,72335,0.0009677196377963641,0.0016589479505080527,27
33110,9,24,0.0,41,33119,0.000271747335366406,0.0007246595609770826,8
26489,60,60,0.0,191,26549,0.0022599721270104337,0.0022599721270104337,71
32082,56,64,0.0,176,32138,0.001742485531146929,0.0019914120355964903,56
35196,90,171,0.0,371,35286,0.002550586634926033,0.004846114606359463,110
18130,10,6,0.0,31,18140,0.0005512679162072767,0.000330760749724366,15
12958,20,117,0.0,145,12978,0.0015410695022345508,0.009015256588072122,8
40313,122,140,0.0,1276,40435,0.0030171880796339805,0.003462346976629158,1014
20854,52,50,0.0,150,20906,0.002487324213144552,0.002391657897254377,48
21263,133,183,4667.0,902,21396,0.006216115161712469,0.008553000560852496,586
24415,15,57,2853.0,108,24430,0.0006139991813344249,0.0023331968890708144,36
16418,17,119,0.0,347,16435,0.001034377852144813,0.0072406449650136906,211
16142,36,168,0.0,377,16178,0.0022252441587340835,0.010384472740759055,173
13384,26,80,0.0,285,13410,0.0019388516032811335,0.005965697240865026,179
33211,41,112,0.0,240,33252,0.0012330085408396487,0.003368218453025382,87
19105,47,46,0.0,124,19152,0.002454051796157059,0.0024018379281537175,31
36937,138,115,6116.0,406,37075,0.003722184760620364,0.0031018206338503033,153
34836,123,165,75.0,867,34959,0.003518407277096027,0.004719814640006865,579
23440,14,31,0.0,64,23454,0.0005969131065063529,0.0013217361644069243,19
21511,13,14,645.0,56,21524,0.0006039769559561419,0.0006504367217989222,29
16889,117,365,1617.0,946,17006,0.006879924732447372,0.02146301305421616,464
26173,455,715,28160.0,1752,26628,0.01708727655099895,0.026851434580141206,582
240136,161,99,350478.0,657,240297,0.0006700042031319575,0.0004119901621743093,397
16960,64,74,17667.0,687,17024,0.0037593984962406013,0.004346804511278195,549
13427,47,215,7874.0,587,13474,0.0034881994953243284,0.01595665726584533,325
30583,33,204,0.0,1120,30616,0.0010778677815521296,0.006663182649594983,883
44717,235,270,0.0,3821,44952,0.005227798540665599,0.00600640683395622,3316
42523,1222,1406,3.0,4701,43745,0.027934621099554236,0.0321408160932678,2073
18175,617,835,268.0,2361,18792,0.032833120476798636,0.04443380161770966,909
19298,125,111,203.0,1324,19423,0.006435669052154662,0.00571487411831334,1088
14716,20,115,0.0,737,14736,0.0013572204125950054,0.007804017372421281,602
20035,159,228,0.0,1510,20194,0.007873625829454294,0.011290482321481629,1123
12736,411,216,167.0,1206,13147,0.031261884840648055,0.016429603711873433,579
16330,27,87,144.0,835,16357,0.001650669438161032,0.005318823745185547,721
10974,18,81,0.0,501,10992,0.0016375545851528383,0.007368995633187773,402
10955,12,51,107.0,364,10967,0.0010941916659068112,0.004650314580103948,301
18446,357,1080,110.0,2180,18803,0.01898633196830293,0.05743764292931979,743
15238,46,86,30.0,818,15284,0.0030096833289714733,0.005626799267207537,686
15643,27,105,0.0,866,15670,0.0017230376515634971,0.006700701978302489,734
14655,183,228,55.0,1021,14838,0.012333198544278204,0.015365952284674484,610
25930,1352,1939,37.0,4219,27282,0.04955648412872957,0.07107250201598124,928
29133,147,202,0.0,2252,29280,0.0050204918032786885,0.006898907103825137,1903
22485,172,272,42.0,1916,22657,0.007591472834002737,0.012005119830515954,1472
19870,399,311,0.0,1623,20269,0.019685233607972766,0.015343628200700577,913
22383,395,316,5.0,2075,22778,0.017341294231275794,0.013873035385020634,1364
15860,394,358,65.0,1601,16254,0.024240187030884704,0.022025347606742955,849
15552,115,198,0.0,1212,15667,0.007340269355971149,0.012638028978106848,899
12826,36,116,2.0,752,12862,0.0027989426216762556,0.009018815114290157,600
18695,436,425,5.0,1819,19131,0.022790235743034865,0.022215252731169307,958
12923,11,75,41.0,590,12934,0.0008504716251739601,0.005798670171640637,504
47904,777,1035,0.0,4458,48681,0.015961052566709804,0.02126086152708449,2646
23345,1042,1276,0.0,3329,24387,0.04272768278180998,0.05232295895354082,1011
35440,387,580,0.0,2736,35827,0.010801909174644821,0.01618890780696123,1769
21087,345,322,0.0,1913,21432,0.016097424412094066,0.015024262784621127,1246
13848,149,225,0.0,1138,13997,0.010645138243909408,0.016074873187111524,764
31806,777,895,0.0,3442,32583,0.02384679127152196,0.02746831169628334,1770
12256,121,68,11.0,785,12377,0.009776197786216368,0.005494061565807546,596
23079,778,1024,0.0,2858,23857,0.032610973718405496,0.04292241270905814,1056
18450,47,111,5.0,1240,18497,0.0025409525869059847,0.006000973130777964,1082
15935,100,278,54.0,1242,16035,0.006236357966947303,0.0173370751481135,864
19532,1199,1271,0.0,3026,20731,0.057836090878394676,0.06130915054748927,556
12680,50,83,0.0,819,12730,0.003927729772191673,0.006520031421838177,686
23006,515,346,0.0,2284,23521,0.02189532757960971,0.01471025891756303,1423
24653,720,1130,0.0,3002,25373,0.028376620817404326,0.04453552989398179,1152
16714,291,357,0.0,1806,17005,0.01711261393707733,0.020993825345486623,1158
16080,100,150,102.0,975,16180,0.006180469715698393,0.009270704573547589,725
17861,42,109,65.0,919,17903,0.0023459755348265656,0.006088365078478467,768
12873,71,167,0.0,863,12944,0.005485166872682324,0.012901730531520396,625
14346,467,543,0.0,1523,14813,0.03152636197934247,0.036656990481333966,513
23082,111,185,75.0,1625,23193,0.004785926788255077,0.007976544647091795,1329
12441,27,46,126.0,690,12468,0.002165543792107796,0.0036894449791466154,617
16326,36,143,0.0,942,16362,0.0022002200220022,0.008739762865175407,763
20068,83,200,0.0,1371,20151,0.004118902287727657,0.009925065753560617,1088
22650,408,506,0.0,2168,23058,0.017694509497788186,0.021944661288923584,1254
21758,57,99,0.0,1554,21815,0.002612881045152418,0.004538161815264726,1398
13942,43,188,228.0,1057,13985,0.0030747229174115124,0.013442974615659636,826
22577,62,177,0.0,1588,22639,0.002738636865585936,0.007818366535624365,1349
18383,83,275,67.0,1412,18466,0.004494747102783494,0.0148922343766923,1054
16299,229,186,155.0,1047,16528,0.013855275895450145,0.011253630203291384,632
25086,160,208,87.0,1781,25246,0.006337637645567614,0.008238928939237899,1413
12994,286,395,1303.0,1228,13280,0.02153614457831325,0.029743975903614456,547
23565,1086,1543,168.0,3572,24651,0.0440550079104296,0.06259380958176139,943
18081,366,1084,357.0,2170,18447,0.019840624491787282,0.05876294248387272,720
12979,387,350,50.0,1367,13366,0.028954062546760438,0.026185844680532696,630
12077,42,239,190.0,965,12119,0.003465632477927222,0.019721099100585858,684
16367,32,83,0.0,920,16399,0.0019513384962497713,0.005061284224647845,805
25652,388,278,0.0,2195,26040,0.014900153609831029,0.010675883256528417,1529
28441,89,191,7.0,1905,28530,0.003119523308797757,0.006694707325622152,1625
19301,36,160,0.0,1166,19337,0.0018617158814707554,0.00827429280653669,970
17835,67,69,430.0,1106,17902,0.003742598592336052,0.003854317953301307,970
32641,99,120,0.0,2766,32740,0.0030238240684178374,0.0036652412950519244,2547
19742,524,647,0.0,2206,20266,0.025856113687950263,0.03192539228264088,1035
15765,207,287,166.0,1376,15972,0.012960180315552216,0.017968945654896068,882
21647,594,633,302.0,2381,22241,0.026707432219774292,0.02846095049683018,1154
17367,29,62,25.0,969,17396,0.0016670498965279375,0.003564037709818349,878
15145,110,124,4.0,1177,15255,0.007210750573582432,0.00812848246476565,943
18789,52,123,40.0,1157,18841,0.0027599384321426675,0.006528315906799002,982
24007,225,241,0.0,1780,24232,0.009285242654341367,0.009945526576427863,1314
29910,758,1324,0.0,3737,30668,0.024716316681883396,0.04317203599843485,1655
35708,1058,912,31.0,4065,36766,0.028776587064135342,0.02480552684545504,2095
22683,41,104,3.0,1399,22724,0.0018042598134131315,0.004576659038901602,1254
23293,93,135,0.0,1692,23386,0.003976738219447533,0.005772684512101257,1464
18005,41,75,94.0,889,18046,0.0022719716280616203,0.00415604566108833,773
17091,60,251,1220.0,1015,17151,0.0034983382893125766,0.014634715176957611,704
15278,36,99,0.0,814,15314,0.002350790126681468,0.006464672848374037,679
15973,54,165,85.0,1204,16027,0.0033693142821488737,0.01029512697323267,985
13363,26,112,0.0,579,13389,0.001941892598401673,0.008365075808499515,441
14098,25,79,6.0,770,14123,0.0017701621468526516,0.005593712384054379,666
14701,43,160,102.0,797,14744,0.002916440586001085,0.010851871947911014,594
13274,44,78,68.0,690,13318,0.003303799369274666,0.005856735245532362,568
18334,338,452,377.0,1877,18672,0.01810197086546701,0.024207369323050558,1087
15619,32,53,0.0,714,15651,0.0020445977892786403,0.003386365088492748,629
16719,63,81,322.0,1009,16782,0.003754022166607079,0.004826599928494816,865
13422,26,99,0.0,683,13448,0.001933372992266508,0.0073616894705532425,558
12639,33,95,112.0,784,12672,0.0026041666666666665,0.007496843434343434,656
10752,41,119,1273.0,513,10793,0.0037987584545538773,0.011025664782729547,353
14169,27,234,275.0,899,14196,0.0019019442096365174,0.016483516483516484,638
27020,198,342,0.0,2159,27218,0.007274597692703358,0.012565214196487618,1619
14237,68,75,167.0,639,14305,0.0047535826634044044,0.005242922055225445,496
13778,332,236,16.0,1279,14110,0.023529411764705882,0.016725726435152376,711
21017,379,362,35.0,1859,21396,0.0177135913254814,0.01691905028977379,1118
39501,797,516,0.0,4031,40298,0.019777656459377638,0.012804605687627178,2718
27918,1060,1198,0.0,3696,28978,0.0365794740837877,0.04134170750224308,1438
28773,212,254,0.0,2552,28985,0.007314127997239951,0.008763153355183715,2086
27595,427,617,0.0,2180,28022,0.015238027264292341,0.022018414103204625,1136
27388,97,143,37.0,1698,27485,0.0035291977442241224,0.005202837911588139,1458
38359,134,139,0.0,2964,38493,0.00348115241732263,0.0036110461642376536,2691
14807,129,167,28.0,1013,14936,0.008636850562399571,0.011181039100160686,717
16080,55,48,148.0,909,16135,0.003408738766656337,0.0029748992872637124,806
38601,208,311,0.0,3434,38809,0.005359581540364348,0.008013605091602463,2915
13225,56,123,0.0,809,13281,0.004216549958587456,0.009261350801897448,630
25501,71,184,0.0,1871,25572,0.002776474268731425,0.007195369935867355,1616
24384,86,133,68.0,1749,24470,0.0035145075602778914,0.005435226808336739,1530
16974,86,104,32.0,1074,17060,0.005041031652989449,0.0060961313012895665,884
14705,247,436,14.0,1235,14952,0.016519529159978598,0.029159978598180845,552
30064,115,117,0.0,2475,30179,0.0038105967725902117,0.003876868020809172,2243
36544,477,826,0.0,3111,37021,0.012884579022716836,0.022311660949191,1808
16673,153,177,93.0,1103,16826,0.009093070248425057,0.01051943420896232,773
17504,111,254,348.0,1219,17615,0.006301447629860914,0.014419528810672723,854
12060,78,35,69.0,584,12138,0.006426099851705388,0.0028835063437139563,471
14603,76,121,0.0,913,14679,0.005177464404932216,0.008243068328905239,716
25357,137,196,3.0,1746,25494,0.0053738134463010906,0.007688083470620538,1413
22154,306,236,0.0,1970,22460,0.013624220837043633,0.010507569011576135,1428
21132,61,353,2145.0,1831,21193,0.002878308875572123,0.016656443165196055,1417
25429,957,705,206.0,2932,26386,0.036269233684529674,0.02671871446979459,1270
26684,1554,2508,98.0,5083,28238,0.05503222607833416,0.08881648841985976,1021
22795,67,163,0.0,1493,22862,0.0029306272417111362,0.007129734931327093,1263
17595,28,222,39.0,828,17623,0.0015888327753503944,0.012597174147420984,578
15602,376,1196,38.0,2307,15978,0.023532356990862435,0.0748529227688071,735
17008,31,93,36.0,888,17039,0.00181935559598568,0.00545806678795704,764
13733,159,129,9.0,819,13892,0.011445436222286208,0.00928591995393032,531
17311,151,282,0.0,1241,17462,0.008647348528232734,0.0161493528805406,808
14623,86,216,88.0,868,14709,0.005846760486776803,0.014684886803997552,566
13252,47,118,0.0,702,13299,0.0035341003082938567,0.008872847582525002,537
15272,52,166,0.0,805,15324,0.0033933698773166276,0.010832680762203081,587
14586,43,118,39.0,831,14629,0.0029393670107321075,0.008066169936427644,670
15481,21,71,143.0,672,15502,0.0013546639143336343,0.004580054186556573,580
15194,23,106,0.0,649,15217,0.0015114674377341131,0.006965893408687652,520
13195,40,107,0.0,668,13235,0.003022289384208538,0.008084624102757839,521
13103,46,70,0.0,629,13149,0.003498364894668796,0.0053235987527568635,513
12521,14,53,0.0,379,12535,0.0011168727562824092,0.004228161148783407,312
14420,150,97,62.0,579,14570,0.01029512697323267,0.00665751544269046,332
24069,80,106,0.0,1647,24149,0.0033127665741852666,0.004389415710795478,1461
13510,16,91,3.0,428,13526,0.0011829069939376016,0.00672778352802011,321
11281,44,83,0.0,582,11325,0.0038852097130242826,0.007328918322295806,455
11280,23,59,0.0,475,11303,0.002034858002300274,0.005219853136335486,393
52725,904,912,4.0,5569,53629,0.01685655149266255,0.017005724514721512,3753
14646,144,127,502.0,1206,14790,0.00973630831643002,0.008586883029073698,935
21759,725,971,39.0,2432,22484,0.03224515210816581,0.043186265789005515,736
15156,60,213,0.0,985,15216,0.003943217665615142,0.013998422712933754,712
22391,66,301,1663.0,1618,22457,0.0029389499933205683,0.013403393151355924,1251
36390,1426,1734,0.0,4714,37816,0.03770890628305479,0.045853606938861854,1554
13932,38,142,37.0,895,13970,0.002720114531138153,0.010164638511095204,715
15063,50,58,122.0,803,15113,0.0033084099781644943,0.003837755574670813,695
22190,134,112,0.0,1574,22324,0.006002508511019531,0.0050170220390611,1328
28645,88,106,0.0,1904,28733,0.003062680541537605,0.003689137925033933,1710
25196,76,72,0.0,1751,25272,0.0030072807850585626,0.002849002849002849,1603
25236,73,183,212.0,1707,25309,0.002884349440910348,0.007230629420364297,1451
11451,95,117,0.0,673,11546,0.00822795773428027,0.010133379525376754,461
15179,102,109,67.0,937,15281,0.0066749558274982,0.007133041031346116,726
15018,64,115,0.0,973,15082,0.004243469035936878,0.007624983423949078,794
22183,45,108,12.0,1304,22228,0.002024473636854418,0.004858736728450603,1151
22967,98,217,0.0,1409,23065,0.004248861911987861,0.009408194233687404,1094
12539,61,83,0.0,765,12600,0.004841269841269842,0.006587301587301587,621
18346,98,91,0.0,1132,18444,0.0053133810453263935,0.00493385382780308,943
17142,43,101,2.0,1063,17185,0.0025021821355833574,0.0058772185045097465,919
19876,54,130,0.0,1402,19930,0.002709483191169092,0.006522829904666332,1218
20273,39,63,548.0,1248,20312,0.0019200472627018512,0.0031016148089799134,1146
22992,719,757,51.0,2432,23711,0.03032347855425752,0.03192611024419046,956
21359,299,400,0.0,2023,21658,0.013805522208883553,0.01846892603195124,1324
29721,193,200,1341.0,2624,29914,0.006451828575249047,0.006685832720465334,2231
22425,423,377,0.0,2129,22848,0.018513655462184874,0.016500350140056023,1329
36346,241,307,0.0,3088,36587,0.006587039112252986,0.008390958537185338,2540
14062,107,65,151.0,888,14169,0.007551697367492413,0.0045874797092243635,716
13149,38,36,0.0,843,13187,0.002881625843633882,0.002729961325547888,769
18998,511,644,0.0,2025,19509,0.026193039110154286,0.033010405453893076,870
12025,379,669,0.0,1381,12404,0.03055465978716543,0.053934214769429216,333
14460,389,247,63.0,1278,14849,0.02619705030641794,0.016634116775540442,642
21223,213,163,28.0,1813,21436,0.009936555327486472,0.007604030602724389,1437
32880,728,530,232.0,3178,33608,0.021661509164484647,0.015770054748869316,1920
19471,88,150,405.0,1295,19559,0.004499207525947135,0.007669103737409888,1057
21591,75,257,1382.0,1365,21666,0.0034616449736914984,0.011861903443182867,1033
21098,46,153,4446.0,1252,21144,0.0021755580779417327,0.007236095346197503,1053
18685,54,90,266.0,1166,18739,0.002881690591813864,0.004802817653023107,1022
29587,295,205,32.0,2322,29882,0.009872163844454857,0.00686031724784151,1822
19318,70,231,63.0,1440,19388,0.003610480709717351,0.011914586342067258,1139
17597,602,496,0.0,1524,18199,0.03307874059014231,0.027254244738721907,426
21301,58,143,0.0,1360,21359,0.0027154829345943164,0.006695069993913573,1159
18370,118,132,0.0,1155,18488,0.006382518390307226,0.007139766334919948,905
15018,30,53,48.0,676,15048,0.001993620414673046,0.0035220627325890483,593
32654,510,909,38.0,3635,33164,0.015378120853938006,0.027409238933783622,2216
22231,154,97,13.0,1300,22385,0.0068796068796068794,0.0043332588787134245,1049
27878,85,115,0.0,1735,27963,0.0030397310732038765,0.004112577334334656,1535
21174,120,279,0.0,1676,21294,0.005635390250774866,0.013102282333051564,1277
16946,39,119,110.0,972,16985,0.0022961436561672066,0.007006181925228143,814
15322,45,102,0.0,794,15367,0.0029283529641439448,0.006637600052059608,647
11510,40,103,26.0,787,11550,0.003463203463203463,0.008917748917748918,644
24716,78,81,38.0,1725,24794,0.0031459224005807858,0.003266919415987739,1566
18260,53,88,51.0,1159,18313,0.0028941189319062963,0.004805329547316114,1018
14088,72,113,0.0,857,14160,0.005084745762711864,0.007980225988700565,672
13257,54,70,47.0,663,13311,0.004056795131845842,0.00525880850424461,539
24491,106,149,16.0,1716,24597,0.004309468634386308,0.006057649306826036,1461
13347,90,105,0.0,740,13437,0.006697923643670462,0.007814244250948872,545
15224,56,177,127.0,851,15280,0.0036649214659685864,0.011583769633507853,618
18826,512,1107,280.0,2528,19338,0.0264763677732961,0.05724480297859137,909
29080,110,137,724.0,1860,29190,0.0037684138403562863,0.004693388146625557,1613
17996,35,73,0.0,946,18031,0.001941101436415063,0.004048582995951417,838
11845,27,68,149.0,658,11872,0.002274258760107817,0.0057277628032345014,563
15627,680,340,53.0,1842,16307,0.04169988348561967,0.020849941742809835,822
22984,65,87,0.0,1361,23049,0.0028200789622109417,0.003774567226343876,1209
19299,75,114,0.0,1231,19374,0.00387116754413131,0.005884174667079591,1042
16661,377,452,0.0,1835,17038,0.022127010212466252,0.02652893532104707,1006
12615,28,86,106.0,775,12643,0.002214664241082022,0.006802183026180495,661
11489,30,52,16.0,414,11519,0.0026043927424255577,0.004514280753537633,332
10840,10,70,22.0,222,10850,0.0009216589861751152,0.0064516129032258064,142
19945,55,61,151.0,1155,20000,0.00275,0.00305,1039
18427,53,132,369.0,1016,18480,0.002867965367965368,0.007142857142857143,831
14868,47,90,43.0,659,14915,0.003151190077103587,0.006034193764666443,522
16167,64,306,46.0,1273,16231,0.003943071899451666,0.01885281251925328,903
16299,49,100,2.0,893,16348,0.0029973085392708586,0.006116956202593589,744
19859,53,138,37.0,1135,19912,0.002661711530735235,0.006930494174367216,944
21595,139,59,0.0,1178,21734,0.006395509340204288,0.002714640655194626,980
14363,41,101,494.0,608,14404,0.002846431546792558,0.007011941127464593,466
15242,164,121,32.0,1074,15406,0.01064520316759704,0.007854082824873427,789
20921,92,614,0.0,2059,21013,0.004378242040641508,0.029220006662542236,1353
16267,39,98,208.0,890,16306,0.002391757635226297,0.006010057647491721,753
21136,77,141,0.0,1358,21213,0.0036298496205157214,0.006646867486918399,1140
22028,434,379,37.0,1872,22462,0.019321520790668685,0.016872940966966433,1059
10669,67,56,533.0,516,10736,0.006240685543964232,0.005216095380029807,393
21476,666,1291,0.0,2875,22142,0.030078583687110468,0.05830548279288231,918
22526,76,78,75.0,1360,22602,0.0033625342890009732,0.0034510220334483675,1206
16578,40,78,3.0,962,16618,0.002407028523288001,0.004693705620411602,844
19184,282,152,0.0,1480,19466,0.014486797493064831,0.007808486592006576,1046
20195,61,94,146.0,1306,20256,0.0030114533965244867,0.004640600315955766,1151
13934,41,234,109.0,1071,13975,0.0029338103756708406,0.01674418604651163,796
16830,34,92,0.0,859,16864,0.0020161290322580645,0.005455407969639468,733
14873,72,77,2.0,724,14945,0.004817664770826363,0.005152224824355972,575
11243,24,36,0.0,323,11267,0.002130114493654034,0.0031951717404810507,263
17896,112,122,0.0,1062,18008,0.006219458018658374,0.006774766770324301,828
12338,99,75,114.0,634,12437,0.007960118999758785,0.006030393181635443,460
16144,52,118,0.0,1001,16196,0.0032106693010619906,0.007285749567794517,831
18890,54,157,0.0,1120,18944,0.0028505067567567567,0.008287584459459459,909
13196,58,72,14.0,637,13254,0.0043760374226648555,0.005432322317790856,507
11811,45,186,28.0,652,11856,0.0037955465587044533,0.01568825910931174,421
16258,120,150,24.0,1022,16378,0.007326901941629015,0.009158627427036268,752
16476,40,96,621.0,952,16516,0.002421893921046258,0.00581254541051102,816
13197,236,80,27.0,708,13433,0.017568674160649146,0.0059554827663217446,392
26847,88,221,355.0,1936,26935,0.0032671245591238164,0.00820493781325413,1627
16164,285,431,0.0,1352,16449,0.017326281232901697,0.026202200741686426,636
30132,452,351,219.0,2800,30584,0.01477896939576249,0.011476589066178393,1997
13071,81,249,145.0,1074,13152,0.0061587591240875915,0.01893248175182482,744
20484,399,304,18.0,1869,20883,0.019106450222669158,0.014557295407747929,1166
30666,532,723,0.0,3225,31198,0.01705237515225335,0.02317456247195333,1970
21421,129,161,154.0,1498,21550,0.005986078886310905,0.007470997679814385,1208
12839,63,195,62.0,900,12902,0.004882963881568749,0.01511393582390327,642
21238,770,1346,0.0,3110,22008,0.03498727735368957,0.06115957833515086,994
21545,613,925,589.0,2355,22158,0.02766495171044318,0.04174564491380089,817
13556,165,337,0.0,1326,13721,0.01202536258290212,0.024560892063260696,824
26071,581,1242,35.0,3206,26652,0.02179948971934564,0.04660063034669068,1383
11072,296,855,241.0,1645,11368,0.026038001407459536,0.07521111893033075,494
12137,939,753,172.0,1907,13076,0.07181095136127257,0.057586417864790455,215
11449,253,107,4.0,822,11702,0.02162023585711844,0.009143736113484874,462
48180,239,333,237.0,4394,48419,0.004936078812036597,0.006877465457774841,3822
22874,156,262,412.0,1840,23030,0.006773773339122883,0.011376465479808945,1422
58682,1187,1044,175.0,5878,59869,0.01982662145684745,0.017438073126325813,3647
11979,23,118,316.0,805,12002,0.001916347275454091,0.009831694717547076,664
24597,85,224,0.0,1837,24682,0.003443805202171623,0.009075439591605219,1528
17898,611,382,11.0,1945,18509,0.03301096763736561,0.020638608244637743,952
11592,411,774,0.0,1691,12003,0.03424143964008998,0.06448387903024244,506
14621,64,101,0.0,736,14685,0.004358188627851549,0.006877766428328226,571
16023,46,186,0.0,1025,16069,0.0028626548011699547,0.0115750824569046,793
19106,120,155,43.0,1170,19226,0.006241547903880163,0.00806199937584521,895
11957,14,133,552.0,601,11971,0.0011694929412747472,0.0111101829421101,454
21093,79,328,0.0,1659,21172,0.0037313432835820895,0.015492159455885132,1252
14944,355,180,180.0,1045,15299,0.023204130988953527,0.011765474867638407,510
20841,734,974,0.0,2538,21575,0.034020857473928155,0.04514484356894554,830
11580,34,125,78.0,709,11614,0.0029275012915446876,0.01076287239538488,550
16380,48,185,10.0,1245,16428,0.0029218407596785976,0.01126126126126126,1012
13624,121,89,80.0,827,13745,0.008803201164059658,0.006475081847944707,617
15426,18,71,43.0,934,15444,0.0011655011655011655,0.004597254597254598,845
10867,14,45,56.0,526,10881,0.0012866464479367706,0.0041356492969396195,467
13321,28,137,43.0,651,13349,0.002097535395909806,0.010262941044272979,486
15863,106,224,0.0,1277,15969,0.0066378608554073515,0.014027177656709876,947
11993,10,61,247.0,543,12003,0.0008331250520703157,0.005082062817628926,472
19582,63,144,0.0,1270,19645,0.0032069228811402394,0.007330109442606261,1063
16024,549,303,30.0,1569,16573,0.03312616907017438,0.018282749049659083,717
16097,581,734,77.0,2061,16678,0.03483631130831035,0.044010073150257824,746
34083,202,320,158.0,2987,34285,0.005891789412279422,0.009333527781828789,2465
14515,256,209,5.0,1206,14771,0.017331257193148736,0.014149346692844086,741
15522,70,223,0.0,1150,15592,0.004489481785531041,0.014302206259620318,857
26685,85,183,0.0,1873,26770,0.003175196115054165,0.006836010459469555,1605
14867,260,157,100.0,1136,15127,0.017187809876379984,0.010378792886890989,719
18223,65,62,71.0,1290,18288,0.00355424321959755,0.003390201224846894,1163
14588,39,121,0.0,848,14627,0.0026663020441649006,0.008272373008819306,688
24322,381,380,5.0,2176,24703,0.015423227948022507,0.015382747034773105,1415
17399,38,200,364.0,1196,17437,0.002179273957676206,0.011469862935137925,958
15739,179,184,14.0,1274,15918,0.011245131297901747,0.011559241110692299,911
20245,439,382,0.0,1958,20684,0.02122413459678979,0.01846838135757107,1137
25907,152,277,79.0,2181,26059,0.005832917610038758,0.010629724855136422,1752
16123,99,190,0.0,1225,16222,0.006102823326346936,0.01171248921218099,936
20967,369,311,3.0,1895,21336,0.01729471316085489,0.014576302962129735,1215
17153,58,180,0.0,1143,17211,0.003369937830457266,0.010458427749694962,905
12453,175,149,0.0,1008,12628,0.01385809312638581,0.011799176433322775,684
25540,425,705,35.0,2525,25965,0.016368187945310995,0.027151935297515885,1395
21196,71,147,0.0,1652,21267,0.003338505666055391,0.006912117364931584,1434
29303,407,425,7.0,2810,29710,0.013699091215079099,0.0143049478290138,1978
15675,72,440,0.0,1412,15747,0.004572299485616308,0.027941830189877438,900
13959,261,231,88.0,1346,14220,0.018354430379746836,0.016244725738396623,854
15977,54,253,268.0,1313,16031,0.003368473582434034,0.015781922525107604,1006
16501,51,171,0.0,1300,16552,0.003081198646689222,0.010331077815369743,1078
13206,47,46,51.0,757,13253,0.0035463668603335093,0.00347091224628386,664
17811,166,216,336.0,1456,17977,0.0092340212493742,0.012015352950992935,1074
21911,80,116,66.0,1701,21991,0.0036378518484834707,0.005274885180301032,1505
38543,511,690,133.0,3755,39054,0.013084447175705434,0.0176678445229682,2554
30968,267,304,0.0,2638,31235,0.008548103089482952,0.009732671682407556,2067
24627,761,623,0.0,2090,25388,0.029974791239955886,0.024539152355443516,706
21745,89,140,0.0,1231,21834,0.0040762114133919575,0.006412017953650271,1002
39026,168,184,263.0,3224,39194,0.004286370362810634,0.004694596111649742,2872
36855,244,206,30.0,2906,37099,0.006576996684546753,0.005552710315641931,2456
27376,209,143,6219.0,1782,27585,0.00757658147543955,0.005183976798984955,1430
14861,20,33,0.0,251,14881,0.0013439956992137626,0.002217592903702708,198
17394,27,99,0.0,1392,17421,0.0015498536249354228,0.005682796624763217,1266
20204,62,225,390.0,1753,20266,0.003059311161551367,0.011102338892726734,1466
156369,732,363,123273.0,1579,157101,0.004659422919013883,0.0023106154639372122,484
27762,1246,1520,80623.0,4493,29008,0.04295366795366795,0.05239933811362383,1727
13303,588,416,40848.0,1662,13891,0.04232956590598229,0.02994744798790584,658
14545,130,360,13474.0,1211,14675,0.008858603066439524,0.02453151618398637,721
8669,49,268,7681.0,748,8718,0.005620555173204864,0.03074099564120211,431
8693,76,276,16758.0,782,8769,0.00866689474284411,0.03147451248717072,430
19664,559,721,21579.0,2263,20223,0.027641793996934182,0.035652474904811354,983
14574,418,465,3925.0,1636,14992,0.02788153681963714,0.031016542155816434,753
10042,115,359,15900.0,957,10157,0.01132224081913951,0.035345082209313775,483
10873,71,356,5459.0,967,10944,0.006487573099415204,0.03252923976608187,540
8638,70,141,19233.0,527,8708,0.008038585209003215,0.01619200734956362,316
12709,213,400,19445.0,1276,12922,0.016483516483516484,0.030954960532425323,663
12207,72,504,19518.0,1191,12279,0.005863669679941363,0.04104568775958954,615
10932,434,553,3421.0,1541,11366,0.038184057715995076,0.04865387999296147,554
11462,346,419,36405.0,1350,11808,0.029302168021680217,0.035484417344173444,585
12971,269,464,14131.0,1400,13240,0.020317220543806646,0.035045317220543805,667
9683,76,372,5765.0,962,9759,0.007787683164258633,0.03811865969873963,514
11419,71,462,9954.0,1115,11490,0.006179286335944299,0.0402088772845953,582
12225,55,438,17168.0,1120,12280,0.004478827361563518,0.03566775244299674,627
12813,434,622,18173.0,1704,13247,0.03276213482297879,0.04695402732694195,648
11025,224,382,13180.0,1169,11249,0.019912881144990666,0.033958574095475154,563
12913,85,498,62644.0,1243,12998,0.0065394676104016,0.038313586705647024,660
10972,69,427,6487.0,1052,11041,0.006249433928086224,0.03867403314917127,556
11384,103,322,48180.0,1014,11487,0.008966657961173501,0.028031687995124923,589
10706,86,411,18436.0,1042,10792,0.007968865826538177,0.03808376575240919,545
8569,53,244,11487.0,745,8622,0.006147065646021805,0.028299698445836234,448
9409,53,425,15244.0,959,9462,0.00560135277953921,0.044916508137814413,481
8785,43,267,12447.0,759,8828,0.0048708654281830535,0.030244676030811057,449
9551,56,283,13442.0,830,9607,0.005829082960341418,0.02945768710315395,491
9545,57,289,10705.0,842,9602,0.005936263278483649,0.03009789627161008,496
40262,12,9,6.0,27,40274,0.00029795898098028504,0.00022346923573521378,6
26476,14,5,9.0,28,26490,0.0005285013212533032,0.00018875047187617969,9
30427,38,57,0.0,154,30465,0.0012473330050878056,0.0018709995076317085,59
29428,100,363,0.0,672,29528,0.003386616093199675,0.01229341641831482,209
11924,26,139,14.0,268,11950,0.0021757322175732217,0.011631799163179916,103
13686,23,123,0.0,314,13709,0.001677729958421475,0.008972208038514845,168
20680,84,80,0.0,237,20764,0.004045463301868619,0.0038528221922558272,73
33567,34,141,0.0,329,33601,0.0010118746465878992,0.004196303681438053,154
17257,123,447,8010.0,859,17380,0.007077100115074799,0.02571921749136939,289
34532,67,68,0.0,162,34599,0.001936472152374346,0.001965374721812769,27
17051,93,178,0.0,421,17144,0.005424638357442837,0.010382641157256184,150
18674,89,26,0.0,119,18763,0.004743377924638917,0.0013857059105686724,4
1239128,348,437,2146053.0,1871,1239476,0.0002807638066408708,0.0003525683433967257,1086
72929,52,50,0.0,225,72981,0.0007125142160288294,0.0006851098231046436,123
126976,179,182,77617.0,642,127155,0.0014077307223467421,0.0014313239746765757,281
14314,17,26,0.0,49,14331,0.0011862396204033216,0.0018142488312050799,6
23041,85,43,0.0,162,23126,0.003675516734411485,0.0018593790538787513,34
44892,105,81,0.0,314,44997,0.0023334888992599507,0.0018001200080005333,128
41939,37,46,20.0,160,41976,0.0008814560701353154,0.0010958643034114732,77
35783,83,27,0.0,162,35866,0.002314169408353315,0.0007528020966932471,52
24336,37,340,0.0,517,24373,0.0015180732778074099,0.013949862552824847,140
159530,14,138,467012.0,199,159544,8.775008775008775e-05,0.0008649651506794364,47
13626,1,85,0.0,106,13627,7.338372349012989e-05,0.006237616496661041,20
34701,29,38,0.0,97,34730,0.0008350129570976101,0.0010941549093003166,30
30683,62,20,0.0,133,30745,0.002016588063099691,0.0006505122784192552,51
65996,48,76,0.0,297,66044,0.0007267882018048574,0.0011507479861910242,173
31552,38,33,0.0,122,31590,0.001202912314023425,0.0010446343779677114,51
75943,103,55,0.0,259,76046,0.0013544433632275202,0.0007232464560923651,101
30203,11,34,0.0,48,30214,0.0003640696365923082,0.0011253061494671344,3
29755,74,127,0.0,443,29829,0.002480807268094807,0.0042576016628113585,242
40309,35,27,0.0,166,40344,0.00086753916319651,0.000669244497323022,104
14757,62,26,0.0,137,14819,0.004183818071394831,0.001754504352520413,49
24623,49,307,4.0,423,24672,0.0019860570687418935,0.01244325551232166,67
47910,77,124,0.0,311,47987,0.001604601246170838,0.002584033175651739,110
671632,453,529,1036979.0,1886,672085,0.0006740218871124932,0.000787102821815693,904
35203,74,119,0.0,245,35277,0.002097684043427729,0.003373302718485132,52
29140,49,201,0.0,400,29189,0.0016787145842611943,0.006886155743602042,150
79247,58,62,1749.0,351,79305,0.000731353634701469,0.0007817918164050186,231
26245,52,47,21659.0,225,26297,0.0019774118720766627,0.0017872761151462144,126
30806,25,26,0.0,295,30831,0.0008108721741104732,0.0008433070610748922,244
20990,43,198,0.0,422,21033,0.0020444064089763705,0.009413778348309799,181
302097,117,92,213293.0,573,302214,0.0003871428855049733,0.00030442004672185936,364
79023,67,131,0.0,403,79090,0.0008471361739790113,0.0016563408774813505,205
14511,14,19,0.0,81,14525,0.0009638554216867469,0.0013080895008605851,48
1901322,1305,1002,27807876.0,4032,1902627,0.0006858937668812647,0.0005266402715823963,1725
10304,18,168,0.0,369,10322,0.0017438480914551443,0.016275915520248013,183
57285,19,34,0.0,61,57304,0.0003315649867374005,0.0005933268183721905,8
36145,72,71,0.0,305,36217,0.001988016677251015,0.0019604053345114174,162
13822,26,54,0.0,115,13848,0.001877527440785673,0.00389948006932409,35
30841,53,70,0.0,221,30894,0.001715543471224186,0.0022658121318055286,98
383252,319,595,0.0,1592,383571,0.0008316582849068361,0.0015512121615033462,678
11713,22,82,0.0,161,11735,0.0018747337025990627,0.006987643800596507,57
14297,34,38,0.0,112,14331,0.002372479240806643,0.0026515944456074244,40
98731,16,27,0.0,92,98747,0.00016203023889333347,0.00027342602813250024,49
29930,19,67,0.0,105,29949,0.0006344118334501987,0.0022371364653243847,19
38559,204,80,100.0,679,38763,0.0052627505611020815,0.002063823749451797,395
58053,165,409,0.0,979,58218,0.002834174997423477,0.007025318629976983,405
33928,59,36,0.0,146,33987,0.0017359578662429753,0.0010592285285550358,51
24392,41,37,0.0,125,24433,0.0016780583636884542,0.0015143453525968977,47
69682,98,74,888.0,459,69780,0.001404413872169676,0.0010604757810260819,287
27178,32,204,0.0,403,27210,0.0011760382212421903,0.007497243660418963,167
37115,47,46,0.0,162,37162,0.0012647327915612722,0.0012378235832301815,69
25432,14,168,0.0,371,25446,0.0005501847048652047,0.006602216458382457,189
29368,97,100,0.0,541,29465,0.003292041405056847,0.0033938571186153065,344
50828,35,151,0.0,209,50863,0.0006881229970705621,0.0029687592159329964,23
2198549,1269,1086,35966653.0,3890,2199818,0.000576865904361179,0.0004936772042050751,1535
12194,7,18,7806.0,70,12201,0.0005737234652897303,0.0014752889107450208,45
20867,26,81,7620.0,133,20893,0.001244435935480783,0.0038768965682285934,26
1514279,1122,1109,5676296.0,4214,1515401,0.0007403980860511508,0.0007318194986013603,1983
25450,85,383,0.0,787,25535,0.0033287644409633835,0.01499902095163501,319
13305,50,96,0.0,158,13355,0.0037439161362785474,0.007188318981654811,12
666639,479,537,1893964.0,1717,667118,0.0007180139045865949,0.000804955045434241,701
562957,716,286,1293297.0,1728,563673,0.0012702400150441835,0.0005073863747243526,726
9183,2,48,2300.0,81,9185,0.00021774632553075667,0.00522591181273816,31
263052,347,507,476979.0,1159,263399,0.0013173930045292503,0.0019248364648309219,305
169863,195,932,404581.0,1438,170058,0.0011466676075221395,0.0054804831292853025,311
217851,3138,2324,262600.0,6570,220989,0.014199801800089597,0.010516360542832448,1108
66527,282,490,13084.0,1027,66809,0.004220988190213893,0.0073343411815773325,255
329565,1073,1258,612063.0,2670,330638,0.003245241018878653,0.0038047653324784205,339
29923,654,275,2.0,954,30577,0.021388625437420282,0.008993688066193543,25
37934,37,695,0.0,763,37971,0.0009744278528350584,0.018303442100550422,31
12083,14,187,0.0,210,12097,0.0011573117301810366,0.015458378110275275,9
23673,2,127,30.0,145,23675,8.447729672650475e-05,0.005364308342133052,16
159866,64,372,334953.0,664,159930,0.00040017507659601074,0.0023260176327143125,228
41789,24,67,0.0,107,41813,0.000573984167603377,0.0016023724678927607,16
16697,114,143,0.0,325,16811,0.006781274165724823,0.008506335137707453,68
18297,173,220,0.0,501,18470,0.00936654033567948,0.011911207363291824,108
21671,89,94,0.0,255,21760,0.004090073529411765,0.004319852941176471,72
37531,156,275,709.0,638,37687,0.004139358399448086,0.0072969458964629716,207
25295,48,204,13482.0,370,25343,0.001894014126188691,0.008049560036301938,118
8226,96,233,21078.0,1202,8322,0.011535688536409516,0.02799807738524393,873
8337,79,175,31099.0,1161,8416,0.009386882129277567,0.020793726235741446,907
9484,413,519,16289.0,1883,9897,0.04172981711629787,0.05244013337374962,951
9409,419,324,11596.0,1648,9828,0.04263329263329263,0.03296703296703297,905
9395,426,338,8680.0,1655,9821,0.043376438244577945,0.034416047245697995,891
9422,414,311,23540.0,1653,9836,0.04209028060187068,0.03161854412362749,928
7861,83,181,17916.0,1106,7944,0.010448136958710977,0.022784491440080563,842
8058,91,194,16614.0,1152,8149,0.011167014357589888,0.02380660203705976,867
7257,413,376,38591.0,1400,7670,0.05384615384615385,0.04902216427640156,611
6808,76,230,19195.0,1073,6884,0.011040092969203951,0.033410807669959325,767
6413,96,524,18442.0,1176,6509,0.014748809340912583,0.08050391765248117,556
6514,94,436,16502.0,1101,6608,0.014225181598062953,0.06598062953995157,571
2198,7,80,26724.0,279,2205,0.0031746031746031746,0.036281179138321996,192
2198,7,80,43852.0,278,2205,0.0031746031746031746,0.036281179138321996,191
2529,6,92,16973.0,340,2535,0.002366863905325444,0.03629191321499014,242
2539,7,82,10120.0,333,2546,0.0027494108405341712,0.03220738413197172,244
2531,6,90,10292.0,338,2537,0.002364998029168309,0.035474970437524636,242
2534,7,87,13967.0,331,2541,0.0027548209366391185,0.03423848878394333,237
2540,7,81,9552.0,333,2547,0.0027483313702394976,0.03180212014134275,245
2154,2,85,31239.0,266,2156,0.0009276437847866419,0.03942486085343228,179
2274,5,106,14478.0,292,2279,0.002193944712593243,0.046511627906976744,181
2155,6,84,14400.0,265,2161,0.002776492364645997,0.03887089310504396,175
2526,6,95,11019.0,333,2532,0.002369668246445498,0.03751974723538705,232
2406,5,95,22223.0,317,2411,0.002073828287017835,0.03940273745333887,217
2462,7,92,14906.0,307,2469,0.0028351559335763467,0.0372620494127177,208
2346,3,101,20179.0,313,2349,0.001277139208173691,0.04299702000851426,209
2533,7,88,13193.0,314,2540,0.0027559055118110236,0.03464566929133858,219
2343,4,104,24726.0,311,2347,0.0017043033659991478,0.044311887515977845,203
2359,3,100,10677.0,286,2362,0.0012701100762066045,0.04233700254022015,183
2541,7,80,13249.0,330,2548,0.0027472527472527475,0.03139717425431711,243
2464,8,90,13774.0,304,2472,0.003236245954692557,0.03640776699029126,206
2356,5,91,14633.0,285,2361,0.0021177467174925877,0.0385429902583651,189
2155,2,84,11097.0,265,2157,0.0009272137227630969,0.03894297635605007,179
2525,5,96,11573.0,335,2530,0.001976284584980237,0.037944664031620556,234
2531,6,90,11408.0,330,2537,0.002364998029168309,0.035474970437524636,234
2521,6,100,22602.0,342,2527,0.002374356944994064,0.03957261574990107,236
2150,2,89,25390.0,266,2152,0.0009293680297397769,0.041356877323420076,175
2511,7,110,24877.0,357,2518,0.0027799841143764893,0.043685464654487687,240
2140,2,99,16307.0,269,2142,0.0009337068160597573,0.046218487394957986,168
2464,9,105,31501.0,321,2473,0.003639304488475536,0.042458552365547915,207
2141,2,98,30305.0,270,2143,0.0009332711152589828,0.045730284647690154,170
2160,2,79,26237.0,259,2162,0.0009250693802035153,0.03654024051803885,178
2126,4,113,12295.0,291,2130,0.0018779342723004694,0.053051643192488264,174
2356,5,145,12531.0,380,2361,0.0021177467174925877,0.06141465480728505,230
2356,5,145,23062.0,378,2361,0.0021177467174925877,0.06141465480728505,228
2127,6,87,9859.0,269,2133,0.0028129395218002813,0.040787623066104076,176
2541,7,80,25703.0,317,2548,0.0027472527472527475,0.03139717425431711,230
2542,7,79,10014.0,334,2549,0.002746174970576697,0.030992546096508436,248
2303,4,77,17619.0,287,2307,0.0017338534893801473,0.03337667967056784,206
2540,7,81,19455.0,332,2547,0.0027483313702394976,0.03180212014134275,244
2538,7,83,15942.0,316,2545,0.00275049115913556,0.03261296660117878,226
2539,8,82,57784.0,323,2547,0.0031409501374165686,0.03219473890851983,233
2367,4,80,36452.0,290,2371,0.001687051876845213,0.03374103753690426,206
2127,5,112,31549.0,292,2132,0.0023452157598499064,0.0525328330206379,175
2522,6,92,15053.0,326,2528,0.0023734177215189874,0.03639240506329114,228
2528,7,86,17400.0,332,2535,0.0027613412228796844,0.033925049309664695,239
2273,4,100,29098.0,280,2277,0.001756697408871322,0.04391743522178305,176
18775,37,293,0.0,394,18812,0.0019668296831809482,0.015575164788432915,64
23554,166,38,4882.0,444,23720,0.0069983136593591904,0.0016020236087689714,240
