match,insertion,deletion,soft_clipping,NM,lengths,INS_readLength,DEL_readLength,NM_INS_DEL
2015,72,11,21689.0,273,2087,0.03449928126497365,0.005270723526593196,190
2018,72,8,29436.0,278,2090,0.03444976076555024,0.003827751196172249,198
2007,71,7,46350.0,267,2078,0.034167468719923,0.003368623676612127,189
29783,49,64,0.0,125,29832,0.001642531509788147,0.002145347278090641,12
2418289,1276,1135,9222991.0,5297,2419565,0.0005273675226745303,0.0004690925848241316,2886
1799680,1855,1860,815229.0,6112,1801535,0.001029677469491295,0.0010324528804602742,2397
355905,96,289,673044.0,817,356001,0.0002696621638703262,0.0008117954724846278,432
202197,596,527,61948.0,1694,202793,0.0029389574590838936,0.0025987090284181405,571
43737,127,461,12869.0,883,43864,0.002895312784971731,0.01050975743206274,295
59012,22,133,2.0,175,59034,0.0003726665989091032,0.002252938984314124,20
80039,105,452,6.0,1308,80144,0.0013101417448592534,0.005639848273108405,751
25294,19,52,0.0,82,25313,0.0007506024572354127,0.002054280409275866,11
26483,35,132,2.0,181,26518,0.0013198582095180632,0.004977750961610981,14
65839,6,26,60685.0,72,65845,9.112309211025894e-05,0.0003948667324777887,40
15619,26,122,9447.0,558,15645,0.0016618728028124001,0.00779801853627357,410
13551,23,111,0.0,496,13574,0.0016944157949020187,0.008177397966701047,362
69509,275,154,0.0,1675,69784,0.003940731399747793,0.0022068095838587644,1246
44929,143,281,13557.0,1482,45072,0.003172701455449059,0.006234469293574725,1058
45619,14,154,43346.0,929,45633,0.00030679552078539653,0.0033747507286393617,761
34766,6,42,13549.0,648,34772,0.00017255262855170826,0.001207868399861958,600
32774,6,22,49775.0,560,32780,0.0001830384380719951,0.0006711409395973154,532
13894,120,74,32.0,1112,14014,0.00856286570572285,0.005280433851862424,918
45610,737,583,130.0,3446,46347,0.015901784365762617,0.012579023453513713,2126
39729,212,374,0.0,4247,39941,0.005307829047845572,0.00936381162214266,3661
4104,6,108,0.0,143,4110,0.00145985401459854,0.026277372262773723,29
20905,671,1415,10179.0,2324,21576,0.031099369670003707,0.06558212829069336,238
15922,141,316,13.0,1003,16063,0.008777936873560356,0.019672539376206187,546
65757,227,349,8735.0,6498,65984,0.003440227934044617,0.005289161008729389,5922
19710,148,150,109.0,1397,19858,0.007452915701480512,0.007553630778527546,1099
24226,48,84,0.0,958,24274,0.0019774244047128615,0.0034604927082475074,826
5753,6,247,10.0,294,5759,0.0010418475429762111,0.04288939051918736,41
16103,22,34,0.0,666,16125,0.0013643410852713178,0.002108527131782946,610
31981,48,171,403.0,1524,32029,0.0014986418558181648,0.005338911611352212,1305
44176,1245,1968,8487.0,4675,45421,0.027410228748816625,0.043327976046322186,1462
15527,194,157,0.0,1253,15721,0.012340181922269575,0.009986642071115069,902
14339,44,77,650.0,927,14383,0.0030591670722380586,0.005353542376416603,806
43111,2129,3310,4417.0,6415,45240,0.04706012378426171,0.07316534040671972,976
16372,24,25,0.0,480,16396,0.001463771651622347,0.0015247621371066115,431
59751,1369,1397,0.0,5611,61120,0.022398560209424084,0.022856675392670157,2845
7309,4,10,0.0,65,7313,0.0005469711472719814,0.0013674278681799535,51
14507,591,721,0.0,1609,15098,0.039144257517551996,0.04775466949264803,297
35835,1189,1084,11986.0,3276,37024,0.03211430423509075,0.029278305963699222,1003
36970,1013,811,0.0,4000,37983,0.02666982597477819,0.02135165732038017,2176
21208,70,80,0.0,1795,21278,0.003289782874330294,0.003759751856377479,1645
84054,1834,1572,571.0,10035,85888,0.02135339046199702,0.01830290611028316,6629
169013,7023,7691,2121.0,25852,176036,0.03989524869912972,0.043689927060374015,11138
26215,706,1407,191.0,2921,26921,0.02622488020504439,0.05226403179673861,808
16656,105,296,0.0,680,16761,0.006264542688383748,0.017660044150110375,279
34423,456,343,0.0,2979,34879,0.013073769316780871,0.00983399753433298,2180
45486,1618,1512,0.0,5950,47104,0.034349524456521736,0.032099184782608696,2820
42544,1744,2414,1123.0,6367,44288,0.039378612716763,0.05450686416184971,2209
28284,773,1369,2468.0,3597,29057,0.026602883986646935,0.04711429259730874,1455
13220,50,666,0.0,948,13270,0.0037678975131876413,0.05018839487565938,232
21054,617,1069,336.0,3063,21671,0.028471228831156846,0.04932859581929768,1377
18948,763,1099,0.0,2639,19711,0.03870935010907615,0.05575566942316473,777
15039,243,79,17553.0,1487,15282,0.015901060070671377,0.005169480434498102,1165
6748,27,89,23.0,174,6775,0.003985239852398524,0.013136531365313652,58
30306,146,83,3112.0,2259,30452,0.004794430579272297,0.0027256009457506895,2030
34868,123,152,18.0,2775,34991,0.003515189620188048,0.00434397416478523,2500
33371,113,278,209.0,2369,33484,0.0033747461474136903,0.008302472822840759,1978
110967,4939,5647,26.0,18491,115906,0.04261211671526927,0.048720514900005174,7905
21780,82,55,0.0,1386,21862,0.0037508004757112797,0.0025157808068795168,1249
55692,265,264,298.0,5775,55957,0.0047357792590739314,0.004717908393945351,5246
30715,97,118,21.0,1826,30812,0.003148124107490588,0.0038296767493184473,1611
33742,418,532,228.0,3606,34160,0.012236533957845434,0.01557377049180328,2656
17484,470,641,1313.0,1478,17954,0.02617801047120419,0.03570235045115295,367
27435,75,104,0.0,1566,27510,0.0027262813522355507,0.003780443475099964,1387
46198,106,211,259.0,2304,46304,0.0022892190739460952,0.004556841741534209,1987
45007,2043,1878,0.0,7704,47050,0.043421891604675876,0.03991498405951116,3783
37825,70,81,0.0,1308,37895,0.0018472093943792058,0.002137485156353081,1157
31488,695,1245,9.0,2939,32183,0.02159525215175714,0.03868502004163689,999
13754,95,112,50.0,1043,13849,0.00685970106144848,0.008087226514549788,836
37171,955,1595,11824.0,3783,38126,0.025048523317421183,0.04183496826312753,1233
49997,613,651,0.0,4789,50610,0.012112230784429955,0.012863070539419087,3525
31344,101,142,68.0,2170,31445,0.0032119573859119097,0.0045158212752424865,1927
36839,110,180,125.0,2284,36949,0.002977076510866329,0.004871579745053993,1994
24526,45,109,0.0,865,24571,0.0018314272923364943,0.00443612388588173,711
15730,29,43,206.0,678,15759,0.001840218287962434,0.0027285995304270577,606
18744,57,156,0.0,389,18801,0.003031753630126057,0.00829743098771342,176
24069,468,654,5435.0,3578,24537,0.01907323633696051,0.026653625137547377,2456
18209,168,218,0.0,1394,18377,0.009141862110246503,0.011862654404962725,1008
11811,292,165,0.0,895,12103,0.024126249690159463,0.013632983557795587,438
25083,851,708,822.0,2046,25934,0.032814066476440196,0.027300069406956118,487
29840,75,74,3499.0,2283,29915,0.0025071034598027745,0.002473675413672071,2134
40094,154,122,1242.0,3768,40248,0.0038262770820910357,0.0030312065195786126,3492
48389,142,271,7.0,3489,48531,0.002925964847211061,0.005584059673198574,3076
22968,368,329,213.0,1448,23336,0.01576962632841961,0.014098388755570792,751
25198,719,994,1442.0,2150,25917,0.02774240845776903,0.038353204460392795,437
25646,586,652,4.0,2333,26232,0.022339127782860627,0.02485513876181763,1095
17736,249,345,2153.0,971,17985,0.01384487072560467,0.019182652210175146,377
58477,892,1079,672.0,6142,59369,0.015024676177803231,0.01817446815678216,4171
38407,101,163,0.0,2237,38508,0.0026228316194037604,0.004232886672899138,1973
20173,361,264,112.0,1143,20534,0.01758059803253141,0.0128567254309925,518
11164,6,1,24821.0,78,11170,0.0005371530886302597,8.952551477170994e-05,71
18094,177,236,11714.0,661,18271,0.009687482896393191,0.012916643861857589,248
12221,48,44,19375.0,280,12269,0.003912299290895754,0.003586274349987774,188
10673,75,67,32491.0,323,10748,0.006978042426497953,0.006233717901004838,181
30505,196,567,219287.0,1927,30701,0.006384156867854467,0.01846845379629328,1164
10066,20,92,0.0,397,10086,0.00198294665873488,0.009121554630180448,285
34480,189,381,40730.0,2065,34669,0.0054515561452594535,0.010989644927745248,1495
13118,2,3,55025.0,133,13120,0.0001524390243902439,0.00022865853658536587,128
13118,3,3,28126.0,129,13121,0.00022864110967151893,0.00022864110967151893,123
13114,3,7,21718.0,138,13117,0.00022871083326980255,0.0005336586109628726,128
5648,26,55,0.0,94,5674,0.004582305252026789,0.009693338033133592,13
2340137,1001,1017,23791179.0,3401,2341138,0.00042756983996671704,0.0004344041231230282,1383
11673,10,8,40474.0,64,11683,0.0008559445347941454,0.0006847556278353163,46
2593007,1355,1359,29450947.0,4836,2594362,0.0005222864041332705,0.0005238282090163208,2122
9083,28,25,11826.0,214,9111,0.003073208209856218,0.002743935901657337,161
188610,1156,458,1080869.0,1940,189766,0.006091712951740565,0.0024134987300148602,326
