match,insertion,deletion,soft_clipping,NM,lengths,INS_readLength,DEL_readLength,NM_INS_DEL
37688,11,102,6797.0,2122,37699,0.00029178492798217457,0.0027056420594710733,2009
48912,26,362,0.0,1368,48938,0.00053128448240631,0.007397114716580163,980
47401,171,938,434.0,3576,47572,0.0035945514167997983,0.01971748087110065,2467
37355,28,82,128.0,1350,37383,0.0007490035577668994,0.002193510419174491,1240
11447,7,18,9985.0,720,11454,0.0006111402130260171,0.001571503404924044,695
20047,5,12,14464.0,1164,20052,0.00024935168561739476,0.0005984440454817474,1147
22560,33,155,44451.0,1231,22593,0.0014606293984862568,0.006860532023193025,1043
19192,16,138,3984.0,890,19208,0.0008329862557267805,0.0071845064556434815,736
15691,20,541,0.0,971,15711,0.001272993444083763,0.03443447266246579,410
10262,12,28,0.0,256,10274,0.0011679968853416391,0.002725326065797158,216
10832,22,18,0.0,462,10854,0.002026902524414962,0.001658374792703151,422
20658,8,14,38759.0,419,20666,0.0003871092615890835,0.0006774412077808962,397
6633,27,39,15693.0,193,6660,0.004054054054054054,0.005855855855855856,127
6597,26,74,14899.0,233,6623,0.003925713422920127,0.0111731843575419,133
8223,4,205,28720.0,580,8227,0.0004862039625622949,0.024917953081317612,371
9808,12,120,16426.0,752,9820,0.0012219959266802445,0.012219959266802444,620
9565,117,154,17342.0,844,9682,0.012084280107415824,0.015905804585829374,573
6561,58,110,20867.0,299,6619,0.008762652968726393,0.016618824595860403,131
6667,1,4,54640.0,131,6668,0.00014997000599880023,0.0005998800239952009,126
9626,32,139,52347.0,752,9658,0.0033133153862083247,0.014392213708842411,581
6619,3,52,48673.0,176,6622,0.000453035336756267,0.007852612503775294,121
30196,325,363,28987.0,5054,30521,0.010648406015530291,0.011893450411192294,4366
6565,34,106,41360.0,293,6599,0.005152295802394302,0.01606303985452341,153
6666,1,5,16706.0,132,6667,0.00014999250037498125,0.0007499625018749063,126
6665,1,6,17254.0,133,6666,0.00015001500150015003,0.0009000900090009,126
6654,27,17,2652.0,175,6681,0.004041311180960934,0.002544529262086514,131
6665,3,6,35228.0,136,6668,0.00044991001799640074,0.0008998200359928015,127
22228,99,295,8695.0,3264,22327,0.004434093250324719,0.013212702109553455,2870
6572,74,98,9745.0,320,6646,0.011134517002708396,0.014745711706289497,148
6588,9,15,17624.0,442,6597,0.001364256480218281,0.002273760800363802,418
9634,30,121,37765.0,774,9664,0.003104304635761589,0.01252069536423841,623
6634,5,27,33823.0,199,6639,0.0007531254707034192,0.004066877541798464,167
9324,107,150,17151.0,866,9431,0.01134556250662708,0.015904994168168804,609
6622,5,39,21394.0,206,6627,0.0007544892108042855,0.005885015844273427,162
6564,22,96,31826.0,291,6586,0.0033404190707561495,0.014576374126935925,173
6558,24,83,73195.0,271,6582,0.0036463081130355514,0.012610148890914616,164
6353,31,93,14242.0,250,6384,0.004855889724310777,0.01456766917293233,126
25422,285,303,12683.0,4149,25707,0.011086474501108648,0.011786672890652352,3561
8603,48,189,42756.0,791,8651,0.005548491503872385,0.021847185296497516,554
5490,12,67,13598.0,189,5502,0.0021810250817884407,0.012177390039985459,110
52906,171,1443,1082.0,3172,53077,0.003221734461254404,0.02718691712040997,1558
39353,53,230,0.0,1184,39406,0.0013449728467746027,0.005836674618078465,901
37222,715,923,482.0,2422,37937,0.01884703587526689,0.024329809948071802,784
32191,44,128,0.0,945,32235,0.001364975957809834,0.003970839149992245,773
35281,1488,1205,2671.0,3652,36769,0.04046887323560608,0.03277217221028584,959
25164,101,102,31.0,2704,25265,0.003997625173164457,0.004037205620423511,2501
22429,6,559,13697.0,961,22435,0.0002674392689993314,0.02491642522843771,396
58098,854,1299,0.0,3269,58952,0.014486361785859683,0.022034875831184693,1116
20945,52,79,0.0,1596,20997,0.0024765442682287944,0.0037624422536552842,1465
89123,449,574,37.0,2792,89572,0.005012727191533069,0.006408252578930916,1769
20237,551,727,48.0,1668,20788,0.02650567635174139,0.0349720992880508,390
63666,1043,1135,77.0,3408,64709,0.01611831429940194,0.01754006397873557,1230
70388,291,195,0.0,4091,70679,0.0041172059593372855,0.0027589524469785933,3605
76503,688,3018,0.0,5115,77191,0.008912956173647187,0.03909782228498141,1409
80559,355,213,3.0,2433,80914,0.0043873742492028574,0.0026324245495217146,1865
61488,371,1287,17.0,3150,61859,0.0059975104673531746,0.02080537997704457,1492
31423,16,34,35427.0,565,31439,0.0005089220395050733,0.0010814593339482808,515
15157,765,461,0.0,1749,15922,0.048046727798015325,0.028953649039065443,523
26532,13,55,0.0,521,26545,0.000489734413260501,0.0020719532868713505,453
28656,103,316,0.0,1102,28759,0.003581487534337077,0.010987864668451615,683
41285,207,336,829.0,4111,41492,0.004988913525498891,0.008097946592114142,3568
40890,1221,2057,0.0,4370,42111,0.02899479945857377,0.04884709458336302,1092
80137,235,490,0.0,2431,80372,0.002923903847110934,0.006096650574827054,1706
83213,781,1273,2917.0,4965,83994,0.009298283210705527,0.015155844465080838,2911
43554,1635,1894,150.0,6158,45189,0.036181371572727876,0.04191285489831596,2629
31122,901,757,12378.0,3387,32023,0.02813602723042813,0.02363925928239078,1729
16553,349,532,12119.0,1276,16902,0.020648443971127677,0.0314755650218909,395
39694,1104,884,0.0,4376,40798,0.0270601500073533,0.021667728810235796,2388
54021,45,283,0.0,1576,54066,0.0008323160581511485,0.0052343432101505565,1248
65304,2483,3201,957.0,7208,67787,0.03662944222343517,0.047221443639635916,1524
41000,132,190,2489.0,4376,41132,0.003209180200330643,0.004619274530778956,4054
35379,71,462,0.0,1235,35450,0.002002820874471086,0.01303244005641749,702
37206,39,179,0.0,1041,37245,0.0010471204188481676,0.004806014230098,823
32533,241,171,0.0,1163,32774,0.007353389882223714,0.005217550497345457,751
21254,34,36,29235.0,760,21288,0.0015971439308530627,0.0016910935738444193,690
41589,153,471,0.0,1591,41742,0.0036653730056058647,0.011283599252551388,967
17987,15,191,0.0,777,18002,0.0008332407510276636,0.01060993222975225,571
43925,1093,1321,163.0,4981,45018,0.02427917721800169,0.029343818028344217,2567
25751,8,42,3744.0,653,25759,0.0003105710625412477,0.0016304980783415505,603
32442,753,1110,179.0,2665,33195,0.022684139177586986,0.033438770899231814,802
32481,10,62,0.0,920,32491,0.0003077775383952479,0.001908220738050537,848
37489,413,660,15891.0,3358,37902,0.010896522610944013,0.017413329111920214,2285
33981,46,173,6354.0,1578,34027,0.0013518676345255238,0.00508419784288947,1359
21236,27,639,0.0,1086,21263,0.0012698114094906645,0.030052203357945728,420
43111,59,456,36.0,1299,43170,0.0013666898309010887,0.010562890896455871,784
4227,9,7,0.0,107,4236,0.002124645892351275,0.0016525023607176581,91
13095,539,529,12796.0,1677,13634,0.03953351914331817,0.03880005867683732,609
18163,709,533,5281.0,1914,18872,0.037568885120813904,0.02824289953370072,672
7623,116,31,5969.0,455,7739,0.01498901666882026,0.0040056854890812765,308
16646,195,207,13397.0,985,16841,0.011578884864319221,0.012291431625200404,583
29238,533,1098,6708.0,2416,29771,0.01790332874273622,0.03688152900473615,785
7495,178,202,8751.0,592,7673,0.023198227551153396,0.026326078456926888,212
17395,200,445,24112.0,1253,17595,0.011366865586814436,0.02529127593066212,608
27493,846,849,0.0,2661,28339,0.02985285295882,0.029958714139525035,966
25608,740,565,3253.0,2027,26348,0.02808562319720662,0.021443752846515864,722
9707,21,19,10027.0,341,9728,0.002158717105263158,0.001953125,301
19003,202,361,36007.0,968,19205,0.010518094246290029,0.01879718823223119,405
14557,363,192,4895.0,937,14920,0.02432975871313673,0.012868632707774798,382
20385,200,129,3536.0,656,20585,0.009715812484819043,0.006266699052708283,327
14601,213,74,5901.0,570,14814,0.01437829080599433,0.004995274740110706,283
19291,204,182,12964.0,787,19495,0.010464221595280841,0.00933572710951526,401
15405,199,52,30762.0,628,15604,0.012753140220456293,0.0033324788515765188,377
16610,362,76,11090.0,824,16972,0.021329248173462174,0.00447796370492576,386
19634,1047,1554,764.0,3134,20681,0.05062617861805522,0.07514143416662637,533
26355,514,599,19189.0,1870,26869,0.019129852246082848,0.022293349212847518,757
11911,3,8,7247.0,199,11914,0.0002518045996306866,0.0006714789323484975,188
31184,1516,2467,72.0,4426,32700,0.04636085626911315,0.0754434250764526,443
21676,353,684,0.0,1501,22029,0.01602433156293976,0.03104997957238186,464
14448,495,316,1444.0,1072,14943,0.0331258783376832,0.021147025363046242,261
19338,411,294,0.0,1016,19749,0.020811180312927238,0.014886829712896855,311
11758,16,230,20570.0,397,11774,0.0013589264481059962,0.019534567691523695,151
10035,28,181,0.0,336,10063,0.0027824704362516147,0.017986683891483654,127
20239,190,66,13815.0,628,20429,0.009300504185226884,0.003230701453815654,372
18691,187,204,7846.0,796,18878,0.00990571035067274,0.010806229473461172,405
28809,1089,971,3747.0,3293,29898,0.03642384105960265,0.032477088768479496,1233
30747,542,64,111421.0,1346,31289,0.017322381667678736,0.002045447281792323,740
30996,728,449,32267.0,2217,31724,0.02294792586054722,0.01415332240574959,1040
20549,546,241,8075.0,1447,21095,0.025882910642332307,0.011424508177293197,660
28001,722,596,96784.0,2031,28723,0.025136650071371374,0.02074992166556418,713
11777,13,49,18741.0,308,11790,0.0011026293469041562,0.004156064461407973,246
19206,201,157,30069.0,717,19407,0.01035708764878652,0.008089864481887978,359
16271,360,820,0.0,1523,16631,0.021646323131501412,0.049305513799531,343
17804,634,446,6074.0,1677,18438,0.034385508189608414,0.02418917453086018,597
58508,2396,2016,24222.0,6454,60904,0.039340601602522,0.033101274136345726,2042
42732,1708,1611,47454.0,4342,44440,0.03843384338433843,0.03625112511251125,1023
14418,371,712,7123.0,1517,14789,0.02508621272567449,0.04814389072959632,434
38086,904,549,5022.0,2195,38990,0.023185432162092845,0.014080533470120544,742
51235,270,967,6991.0,2513,51505,0.005242209494223862,0.018774876225609163,1276
41982,190,442,6538.0,1328,42172,0.004505359005975529,0.010480887792848335,696
40014,1765,2132,11233.0,5675,41779,0.042246104502261905,0.05103042198233562,1778
46787,217,62,0.0,1108,47004,0.004616628372053442,0.001319036677729555,829
31503,134,41,28396.0,763,31637,0.004235546986123842,0.001295950943515504,588
31000,90,368,9218.0,977,31090,0.002894821486008363,0.011836603409456416,519
33603,25,104,8688.0,733,33628,0.0007434280956345902,0.0030926608778398955,604
42138,203,56,0.0,987,42341,0.004794407312061595,0.0013225951205687158,728
25274,17,17,0.0,380,25291,0.0006721758728401408,0.0006721758728401408,346
23435,145,156,2993.0,603,23580,0.006149279050042409,0.0066157760814249365,302
22370,21,80,0.0,501,22391,0.0009378768255102497,0.0035728640971819034,400
20191,11,249,2527.0,521,20202,0.0005445005445005445,0.012325512325512326,261
24612,166,411,23939.0,1225,24778,0.006699491484381306,0.016587295181209136,648
26049,739,1204,3308.0,2504,26788,0.027586979244437808,0.044945497984172016,561
13630,16,39,63878.0,266,13646,0.0011725047633006009,0.0028579803605452148,211
39474,537,530,4.0,1685,40011,0.013421309139986504,0.013246357251755768,618
31574,370,575,8823.0,1716,31944,0.011582769847232657,0.018000250438266967,771
27283,212,406,4456.0,1370,27495,0.0077104928168757955,0.014766321149299873,752
25536,477,865,0.0,1785,26013,0.01833698535347711,0.03325260446699727,443
22162,68,86,652.0,751,22230,0.0030589293747188486,0.0038686459739091317,597
32441,708,545,1363.0,1665,33149,0.021358110350236808,0.01644091827807777,412
9748,118,77,0.0,337,9866,0.011960267585647678,0.007804581390634503,142
26248,708,888,7197.0,2164,26956,0.026265024484344857,0.032942573082059654,568
25250,474,460,2239.0,1982,25724,0.018426372259368683,0.017882133416264965,1048
5213,21,12,20344.0,263,5234,0.004012227741688957,0.0022927015666794038,230
63887,3485,4316,46545.0,9281,67372,0.05172772071483703,0.06406222169447248,1480
18358,371,546,34208.0,1672,18729,0.019808852581558012,0.029152650969085377,755
3088,19,9,23825.0,100,3107,0.006115223688445446,0.002896684905053106,72
11017,1,22,43845.0,207,11018,9.07605736068252e-05,0.0019967326193501543,184
16969,555,563,4387.0,1775,17524,0.03167085140378909,0.032127368180780644,657
108374,53,70,73588.0,282,108427,0.0004888081381943612,0.0006455956542189676,159
82608,58,423,63768.0,759,82666,0.0007016185614400117,0.005116976749812498,278
74888,1626,1531,27640.0,4966,76514,0.02125101288653057,0.020009410042606583,1809
88335,270,484,0.0,926,88605,0.0030472320975114273,0.005462445685909373,172
120541,138,151,132970.0,1229,120679,0.001143529528749824,0.0012512533249364015,940
25843,22,110,23611.0,237,25865,0.0008505702687028803,0.004252851343514402,105
184995,314,249,397850.0,1323,185309,0.0016944670793107729,0.0013437016011094982,760
919409,922,590,7083370.0,2615,920331,0.0010018134779769452,0.0006410737006576981,1103
19657,2,53,3077.0,94,19659,0.00010173457449514217,0.0026959662241212677,39
2472231,2549,2180,22659342.0,7277,2474780,0.0010299905446140667,0.0008808863818197981,2548
27884,37,52,0.0,100,27921,0.0013251674366963934,0.0018623974786003367,11
38780,13,93,19064.0,195,38793,0.00033511200474312374,0.00239733972623927,89
2112798,988,892,45379883.0,3615,2113786,0.00046740776975531107,0.00042199163018394483,1735
12207,10,23,10776.0,39,12217,0.0008185315543914218,0.0018826225751002702,6
24867,56,154,19427.0,277,24923,0.002246920515186775,0.006179031416763632,67
14704,42,92,0.0,166,14746,0.0028482300284823005,0.006238980062389801,32
3858,6,53,0.0,83,3864,0.0015527950310559005,0.013716356107660456,24
968813,1747,1470,12811022.0,4671,970560,0.001799991757335971,0.001514589515331355,1454
26621,1017,1026,6.0,3455,27638,0.036797163325855704,0.03712280193935885,1412
154799,9,9,366571.0,143,154808,5.813653041186502e-05,5.813653041186502e-05,125
